字符	87 五代	註釋
日	a
曰	a
昌	aa
晶	aaa
曝	aate
明	ab
暝	abac
暧	abbe
盟	abbt
晕	abkq
晖	abkq
暖	abme
冒	abu
杲	ad
晰	adhl
时	adi
炅	af
影	afhhh
颢	afmbo
晃	afmu
晌	ahbr
眉	ahbu
曛	ahgf
昴	ahhl
剔	ahln
昕	ahml
星	ahqm
昂	ahvl
晷	ahyr
旷	ai
晟	aihs
晡	aijb
既	aimvu
即	aisl
早	aj
昧	ajd
暑	ajka
暄	ajmm
晓	ajpu
晏	ajv
旯	akn
映	albk
晁	almo
旦	am
晒	amcw
旺	amg
戥	ami
旱	amj
旰	amj
昊	amk
昙	ammi
晤	ammr
晨	ammv
昃	amo
量	amwg
是	amyo
晚	anau
冕	anau
暌	anok
晗	aoir
题	aombo
匙	aop
晔	aopj
韪	aoqs
昨	aos
晦	aowy
易	aphh
昀	apim
昆	app
曷	apvo
晴	aqmb
照	arf
煦	arf
暇	arse
昭	ashr
最	asje
曜	asmg
昵	asp
显	atc
暴	atce
曦	atgs
巴	au
暨	auam
勖	auks
鹛	aupym
艮	av
垦	avg
歇	avno
恳	avp
曙	awla
曼	awle
暾	aydk
景	ayrf
晾	ayrf
曩	ayrv
昱	ayt
暗	ayta
月	b
腽	babt
腥	bahm
幂	bakb
胆	bam
肥	bau
冥	bayc
朋	bb
骨	bbb
受	bbe
髅	bbfdv
骼	bbher
骺	bbhmr
骰	bbhne
觅	bbhu
骶	bbhvi
髀	bbhwj
髂	bbjhr
髌	bbjoc
骷	bbjr
髋	bbjtu
爱	bbke
册	bbm
胴	bbmr
脬	bbnd
舜	bbnq
骱	bboll
鹏	bbpm
鹘	bbpym
髁	bbwd
髑	bbwli
髓	bbykb
骸	bbyvo
罕	bcmj
脱	bcru
采	bd
彩	bdhhh
肘	bdi
郛	bdnl
膝	bdoe
乳	bdu
炙	bf
膛	bfbg
脒	bfd
膦	bfdq
胱	bfmu
胖	bfq
滕	bfqe
塍	bfqg
腾	bfqm
媵	bfqv
肚	bg
氍	bghqu
脚	bgil
周	bgr
臌	bgte
膨	bgth
腺	bhae
脓	bhbv
豺	bhdh
胳	bher
貌	bhhau
貉	bhher
肜	bhhh
貔	bhhwp
貊	bhma
肌	bhn
冗	bhn
股	bhne
貅	bhod
豹	bhpi
胜	bhqm
貂	bhshr
貘	bhtak
见	bhu
胝	bhvi
胍	bhvo
脾	bhwj
舀	bhx
腴	bhxo
膊	bibi
脏	big
脯	bijb
胧	bikp
脉	bine
腑	bioi
悬	bip
腻	bipo
胎	bir
臁	bitc
虢	biypn
脖	bjbd
腩	bjbj
膣	bjcg
腔	bjcm
肢	bje
腙	bjmf
腚	bjmo
脘	bjmu
腕	bjnu
膑	bjoc
胺	bjv
冈	bk
胨	bkd
脎	bkd
然	bkf
肱	bki
肽	bki
网	bkk
刚	bkln
腌	bklu
胯	bkms
胰	bkn
军	bkq
肋	bks
胁	bksc
肿	bl
腓	blmy
刖	bln
胂	blwl
且	bm
肛	bm
胚	bmfm
县	bmi
肝	bmj
爰	bmke
助	bmks
删	bmln
具	bmmc
肟	bmms
朊	bmmu
雎	bmog
同	bmr
膈	bmrb
豚	bmso
冢	bmso
冠	bmui
膘	bmwf
腼	bmwl
腰	bmwv
冤	bnai
孚	bnd
腱	bnkq
脆	bnmu
肷	bno
胫	bnom
肠	bnsh
贝	bo
腹	boae
赐	boaph
肭	bob
赠	bocwa
财	bodh
赕	boff
贩	bohe
赂	boher
胗	bohh
贬	bohio
赙	boibi
赃	boig
贼	boij
贱	boij
赇	boije
贻	boir
赌	bojka
贮	bojm
赎	bojnk
贿	bokb
则	boln
脍	bomi
脸	bomm
祭	bommf
赈	bommv
腧	bomn
赋	bompm
赡	boncr
脞	boog
罂	booju
败	book
赊	boomf
购	bopi
账	bopo
贶	borhu
胙	bos
赆	bosoy
赚	botxc
婴	bov
贴	boyr
赔	boytr
赅	boyvo
脂	bpa
胀	bpo
朐	bpr
胞	bpru
肫	bpu
胸	bpuk
用	bq
皲	bqdhe
腠	bqkk
腈	bqmb
郓	bqnl
肤	bqo
甩	bqu
脶	brob
雕	brog
臊	brrd
腭	brrs
脲	bse
豸	bshh
服	bsle
凸	bss
皿	bt
腊	bta
膜	btak
腆	btbc
朦	btbo
朕	btk
胼	btt
肼	btt
膳	bttr
罔	btyv
目	bu
眼	buav
瞑	bubac
瞬	bubbq
睬	bubd
睇	bucnh
盼	bucsh
睐	budt
瞠	bufbg
眯	bufd
瞵	bufdq
眇	bufh
睦	bugcg
眭	bugg
瞌	bugit
瞅	buhdf
眨	buhio
睡	buhjm
繇	buhvf
睥	buhwj
瞍	buhxe
睨	buhxu
睃	buice
眸	buihq
眙	buir
睹	bujka
睫	bujlo
瞎	bujqr
眈	bulbu
眺	bulmo
盱	bumd
睚	bumgg
眄	bumls
盯	bumn
瞟	bumwf
瞻	buncr
眵	bunin
瞰	bunjk
睽	bunok
瞪	bunot
睁	bunsd
瞿	buog
睢	buog
矍	buoge
瞧	buogf
睑	buomm
盹	bupu
鹞	bupym
睛	buqmb
眠	burvp
瞩	bushb
眍	busk
眶	busmg
瞒	butob
瞄	butw
鼎	buvml
眦	buymp
瞳	buytg
眩	buyvi
妥	bv
奚	bvik
鹦	bvpym
胭	bwk
胛	bwl
爵	bwli
腮	bwp
丹	by
腿	byav
膪	bybr
膀	bybs
胶	byck
彤	byhhh
肮	byhn
肪	byhs
脐	bykl
肺	bylb
胩	bymy
腋	byok
胪	bys
写	bysm
臆	bytp
脑	byuk
臃	byvg
胲	byvo
膻	bywm
金	c
镅	cahu
钽	cam
锝	cami
甑	camvn
锡	caph
锟	capp
钯	cau
银	cav
镘	cawe
锊	cbdi
钢	cbk
锾	cbme
铜	cbmr
锄	cbms
钡	cbo
铡	cbon
钼	cbu
鑫	ccc
锑	ccnh
锐	ccru
铍	cdhe
钵	cdm
铼	cdt
钗	cei
铴	cenh
铎	ceq
钬	cf
销	cfb
镗	cfbg
锁	cfbo
镂	cfdv
锬	cff
钞	cfh
锩	cfqu
铛	cfsm
钍	cg
铂	cha
锦	chab
锹	chdf
锈	chds
钣	che
锋	chej
铬	cher
铥	chgi
锆	chgr
铣	chgu
钐	chhh
铆	chhl
镏	chhw
钎	chj
铢	chjd
锻	chje
锺	chjg
锤	chjm
锸	chjx
剃	chln
锨	chlo
颁	chmbo
钒	chni
铅	chnr
鹈	chpym
锇	chqi
铁	chqo
镍	chud
铄	chvd
锼	chxe
公	ci
锒	ciav
铖	cihs
钱	cij
铺	cijb
钹	cike
镛	cilb
颂	cimbo
瓮	cimn
铽	cipp
翁	cism
镰	citc
镀	cite
钺	civ
镳	cixp
针	cj
镇	cjbc
镲	cjbf
镩	cjcl
锗	cjka
铑	cjkp
铐	cjks
锭	cjmo
镓	cjmo
郸	cjnl
镔	cjoc
铊	cjp
铙	cjpu
钴	cjr
冁	cjstv
铵	cjv
父	ck
爸	ckau
铕	ckb
镣	ckcf
铩	ckd
斧	ckhml
钛	cki
锛	ckjt
钸	cklb
釜	ckmgc
爹	cknin
爷	cksl
铗	ckt
钟	cl
丫	cl
铿	cleg
钏	clll
锵	clmi
铫	clmo
钊	cln
镄	clno
钔	cls
锏	clsa
锎	clst
镧	clsw
铀	clw
镭	cmbw
钚	cmf
钰	cmgi
铘	cmhl
钉	cmn
钶	cmnr
镉	cmrb
镢	cmto
兮	cmvs
镖	cmwf
镡	cmwj
钲	cmym
钙	cmys
钇	cn
铯	cnau
锰	cndt
钮	cng
铭	cnir
铤	cnkg
键	cnkq
弟	cnlh
锕	cnlr
钌	cnn
钦	cno
镫	cnot
镪	cnri
铮	cnsd
镥	cnwa
钠	cob
锥	cog
镌	cogs
铃	coii
钤	coin
铨	comg
镎	comq
铪	comr
锉	coog
铧	copj
谷	cor
镎	corq
铋	cph
锪	cphp
钓	cpi
钩	cpi
钧	cpim
锴	cppa
钝	cpu
钨	cpvm
锲	cqhk
铸	cqki
锖	cqmb
兑	crhu
铞	crlb
锃	crmg
欲	crno
锅	crob
总	crp
鹆	crpym
铝	crr
锷	crrs
分	csh
坌	cshg
贫	csho
忿	cshp
盆	csht
岔	cshu
铒	csj
镊	csje
锯	csjr
锓	csme
铌	csp
钷	csr
钜	css
锔	cssr
错	cta
镆	ctak
铹	ctbs
镨	ctca
镤	ctco
镒	ctct
镁	ctgk
锘	ctkr
钳	ctm
镬	ctoe
锚	ctw
钆	cu
铠	cusu
钕	cv
铷	cvr
锱	cvvw
钿	cw
曾	cwa
锞	cwd
锂	cwg
单	cwj
锢	cwjr
铟	cwk
钾	cwl
镯	cwli
锣	cwln
兽	cwmr
锶	cwp
镙	cwvf
钋	cy
镑	cybs
镝	cycb
铰	cyck
镦	cydk
钪	cyhn
钫	cyhs
铱	cyhv
锍	cyiu
铳	cyiu
钭	cyj
链	cykq
铈	cylb
钻	cyr
镐	cyrb
镶	cyrv
锿	cyrv
镞	cysk
镟	cyso
铲	cyth
锌	cytj
镱	cytp
锫	cytr
镜	cytu
铉	cyvi
木	d
杳	da
楣	dahu
概	daiu
查	dam
棍	dapp
榻	dasm
杷	dau
根	dav
棚	dbb
栅	dbbm
棘	dbdb
枧	dbhu
刺	dbln
桐	dbmr
桴	dbnd
樱	dbov
相	dbu
枣	dby
松	dci
梯	dcnh
林	dd
楂	ddam
棼	ddcsh
森	ddd
焚	ddf
材	ddh
彬	ddhhh
梵	ddhni
村	ddi
麓	ddixp
樊	ddk
攀	ddkq
禁	ddmmf
梦	ddni
郴	ddnl
楚	ddnyo
懋	ddp
婪	ddv
楝	ddwf
权	de
树	dedi
桫	defh
柽	deg
杈	dei
颇	dembo
杰	df
梢	dfb
樘	dfbg
榉	dfcq
楼	dfdv
杪	dfh
桄	dfmu
档	dfsm
杜	dg
棱	dgce
樯	dgcw
桂	dgg
樾	dgov
桔	dgr
才	dh
柏	dha
棉	dhab
槔	dhaj
楸	dhdf
皮	dhe
板	dhe
格	dher
梏	dhgr
杉	dhhh
榭	dhhi
柳	dhhl
榴	dhhw
株	dhjd
椴	dhje
棰	dhjm
栝	dhjr
桥	dhkl
析	dhml
栀	dhmu
柝	dhmy
机	dhn
枫	dhnk
桁	dhon
檄	dhsk
槐	dhui
橇	dhuu
栎	dhvd
柢	dhvi
桕	dhx
寸	di
梭	dice
桩	dig
槭	dihf
榔	diil
栈	dij
栊	dikp
械	dit
槠	diva
末	dj
檫	djbf
楠	djbj
植	djbm
榕	djcr
榨	djcs
枝	dje
杖	djk
楮	djka
栳	djkp
栲	djks
棕	djmf
楦	djmm
柠	djmn
椟	djnk
槟	djoc
柁	djp
桡	djpu
枯	djr
棺	djrr
桉	djv
栋	dkd
椅	dkmr
整	dkmym
枷	dksr
束	dl
枕	dlbu
棣	dle
皙	dlha
槛	dlit
榄	dliu
剌	dlln
桃	dlmo
赖	dlnbo
敕	dlok
榈	dlsr
杩	dlvm
柚	dlw
本	dm
杠	dm
扌	dm
桓	dmam
樗	dmbs
檑	dmbw
栖	dmcw
杯	dmf
枰	dmfj
枉	dmg
桎	dmig
杆	dmj
枥	dmks
梗	dmlk
标	dmmf
柰	dmmf
橱	dmmi
梧	dmmr
柯	dmnr
柄	dmob
柘	dmr
桠	dmtc
橛	dmto
杌	dmu
朽	dmvs
橡	dnao
槲	dnbj
桷	dnbq
檐	dncr
李	dnd
橘	dnhb
极	dnhe
桶	dnib
杼	dnin
橄	dnjk
梃	dnkg
楗	dnkq
椭	dnlb
桅	dnmu
橙	dnot
杨	dnsh
楹	dnst
橹	dnwa
枘	dob
榷	dobg
椎	dog
樵	dogf
榫	dogj
柃	doii
杵	doj
枚	dok
栓	domg
桧	domi
检	domm
榆	domn
枞	doo
桦	dopj
柞	dos
枪	dosu
梅	dowy
檎	doyb
构	dpi
杓	dpi
枨	dpo
枇	dpp
楷	dppa
枸	dpr
楔	dqhk
梆	dqjl
椿	dqka
榛	dqkd
楱	dqkk
棒	dqkq
杏	dr
枳	drc
枵	drms
榀	drrr
楫	drsj
樨	dseq
榍	dsfb
椰	dsjl
椐	dsjr
枢	dsk
榧	dsly
棂	dsmf
框	dsmg
栩	dsmm
柩	dsno
柜	dss
杞	dsu
来	dt
模	dtak
檬	dtbo
赉	dtbo
横	dtlc
槿	dtlm
柑	dtm
棋	dtmc
栏	dtmm
椹	dtmv
样	dtq
槎	dtqm
栉	dtsl
槽	dtwa
樽	dtwi
札	du
想	dup
桤	dusu
橼	dvmo
椽	dvno
棵	dwd
柬	dwf
柙	dwl
椤	dwln
楞	dwls
朴	dy
棹	dyaj
桢	dybo
榜	dybs
校	dyck
椒	dyfe
柱	dyg
杭	dyhn
槌	dyhr
枋	dyhs
梳	dyiu
柿	dylb
槁	dyrb
椁	dyrd
椋	dyrf
栌	dys
榇	dytd
樟	dytj
梓	dytj
核	dyvo
檩	dywf
檀	dywm
榱	dywv
水	e
汨	ea
沓	ea
汩	ea
温	eabt
灏	eafo
涅	eag
湄	eahu
溉	eaiu
混	eapp
渴	eapv
溻	easm
湿	eatc
瀑	eate
艰	eav
漫	eawe
溟	ebac
淝	ebau
滑	ebbb
深	ebcd
淫	ebhg
沉	ebhn
观	ebhu
滔	ebhx
浑	ebkq
沮	ebm
洞	ebmr
浮	ebnd
溅	eboj
测	ebon
懑	ebp
泪	ebu
濉	ebug
渺	ebuh
溪	ebvk
泻	ebym
淦	ec
梁	ecd
粱	ecfd
滏	eckc
涕	ecnh
浴	ecor
汾	ecsh
湓	ecst
沐	ed
渣	edam
湘	edbu
淞	edci
淋	edd
潸	eddb
漤	eddv
波	edhe
淅	edhl
对	edi
沫	edj
涑	edl
濑	edlo
漱	edlo
颡	edmbo
漆	edoe
涞	edt
汉	ee
双	ee
淼	eee
桑	eeed
叠	eeem
汊	eei
滩	eeog
泽	eeq
婆	eev
消	efb
淌	efbr
瀵	efdc
淡	eff
沙	efh
泮	efq
圣	eg
洼	egg
法	egi
溘	egit
洁	egr
澎	egth
澍	egti
泊	eha
湟	ehag
澳	ehbk
洫	ehbt
洎	ehbu
浓	ehbv
潲	ehdb
湫	ehdf
潘	ehdw
涤	ehed
洚	eheq
洛	eher
烫	ehf
浩	ehgr
洗	ehgu
泖	ehhl
滗	ehhu
派	ehhv
溜	ehhw
泛	ehio
洙	ehjd
活	ehjr
沃	ehk
沂	ehml
没	ehne
沿	ehnr
鲨	ehnwm
挲	ehq
湃	ehqj
激	ehsk
溴	ehuk
濞	ehul
娑	ehv
泺	ehvd
溲	ehxe
裟	ehyhv
戏	ei
叉	ei
浪	eiav
溥	eibi
浚	eice
沭	eid
浅	eij
浦	eijb
泼	eike
渗	eikh
泷	eikp
沩	eiks
洲	eill
蚤	eilmi
溏	eilr
泳	eine
怼	eip
治	eir
沪	eis
濂	eitc
渡	eite
浒	eivj
漉	eixp
汁	ej
滇	ejbc
溶	ejcr
渤	ejds
潮	ejjb
瀚	ejjm
渚	ejka
渖	ejll
演	ejmc
淙	ejmf
渲	ejmm
泞	ejmn
淀	ejmo
浣	ejmu
渎	ejnk
滨	ejoc
沱	ejp
浇	ejpu
沽	ejr
湖	ejrb
滓	ejrj
涫	ejrr
洧	ekb
鋈	ekc
潦	ekcf
潴	ekha
漪	ekhr
汰	eki
淆	ekkb
浠	ekkb
淹	eklu
渐	ekql
劝	eks
浃	ekt
泱	elbk
沈	elbu
渊	elfl
滥	elit
沸	elln
漶	ellp
渌	elme
浊	elmi
洮	elmo
溃	elmo
津	elq
涧	elsa
润	elsg
澜	elsw
油	elw
江	em
洹	emam
濡	embb
灞	embb
酒	emcw
洒	emcw
汪	emg
涯	emgg
源	emhf
汗	emj
添	emkp
沥	emks
沔	emls
浯	emmr
污	emms
沅	emmu
汀	emn
洌	emnn
河	emnr
鸿	empm
涿	emso
溽	emvi
溧	emwd
漂	emwf
湮	emwg
潭	emwj
湎	emwl
浼	enau
涣	enbk
澹	encr
染	end
汲	enhe
汐	eni
泓	eni
涌	enib
汛	enj
澉	enjk
涎	enkv
邓	enl
滁	enld
泐	enls
溺	enmm
欢	eno
泾	enom
澄	enot
涨	enpo
汤	ensh
渔	enwm
溆	eode
难	eog
淮	eog
泠	eoii
瀹	eomb
浜	eomc
涂	eomd
浍	eomi
潋	eomk
汽	eomn
渝	eomn
洽	eomr
汔	eon
沦	eop
沲	eopd
沧	eosu
濮	eoto
海	eowy
沁	ep
洵	epa
池	epd
柒	epd
泌	eph
沟	epi
淘	epou
泡	epru
沏	epsh
泄	ept
渫	eptd
沌	epu
鸡	epym
浙	eqhl
沣	eqj
滟	eqju
溱	eqkd
涛	eqki
清	eqmb
渍	eqmo
潜	eqoa
涓	erb
渑	erlu
潞	ermr
涡	erob
澡	errd
汜	eru
泯	ervp
浞	eryo
汇	es
涮	esbn
渠	esd
沼	eshr
涩	esim
洱	esj
滠	esje
沤	esk
渥	esm
漏	esmb
浸	esme
濯	esmg
浔	esmi
潺	esnd
泥	esp
漠	etak
潆	etbf
滢	etbi
湔	etbn
涝	etbs
洪	etc
澌	etcl
溢	etct
港	etcu
漾	etge
漭	etit
滞	etjb
潢	etlc
潇	etlx
泔	etm
淇	etmc
湛	etmv
满	etob
洋	etq
灌	etrg
溯	etub
滋	etvi
漕	etwa
澧	etwt
汕	eu
鎏	euc
汹	euk
湍	eumb
涵	eune
涔	euon
汝	ev
潍	evmg
洳	evr
淄	evvw
渭	ewb
泗	ewc
涸	ewjr
洇	ewk
淠	ewml
溷	ewmo
泅	ewo
涠	ewqs
洄	ewr
漯	ewvf
淖	eyaj
澈	eybk
浈	eybo
滂	eybs
滴	eycb
滦	eycd
湾	eycn
滚	eycv
瀣	eyem
淑	eyfe
注	eyg
沆	eyhn
濒	eyho
流	eyiu
汶	eyk
济	eykl
浏	eykn
涟	eykq
沛	eylb
涉	eylh
瀛	eynv
淬	eyoj
液	eyok
滹	eypd
滤	eypp
沾	eyr
淳	eyrd
凉	eyrf
濠	eyro
泸	eys
游	eysd
漩	eyso
淤	eysy
泣	eyt
潼	eytg
漳	eytj
涪	eytr
漓	eyub
泫	eyvi
澶	eywm
汴	eyy
火	f
焊	famj
爆	fate
熳	fawe
煜	fayt
肖	fb
觉	fbbhu
泶	fbe
喾	fbhgr
燃	fbkf
削	fbln
尝	fbmmi
学	fbnd
鲎	fbnwm
敝	fbok
敞	fbok
尚	fbr
炯	fbr
赏	fbrbo
棠	fbrd
堂	fbrg
党	fbrhu
常	fbrlb
掌	fbrq
裳	fbryv
黉	fbtlc
爝	fbwi
脊	fcb
举	fcq
誉	fcymr
米	fd
粑	fdau
粗	fdbm
粉	fdcsh
粕	fdha
糗	fdhuk
糌	fdhya
粮	fdiav
糁	fdikh
糠	fdile
糖	fdilr
粽	fdjmf
糊	fdjrb
类	fdk
炔	fdk
糯	fdmbb
粞	fdmcw
粳	fdmlk
粝	fdmms
籽	fdnd
糅	fdnhd
糈	fdnob
糨	fdnri
敉	fdok
糇	fdolk
精	fdqmb
粪	fdtc
糕	fdtgf
糍	fdtvi
糟	fdtwa
籼	fdu
娄	fdv
糙	fdyhr
料	fdyj
粹	fdyoj
粘	fdyr
粒	fdyt
炎	ff
燮	ffe
焱	fff
炒	ffh
剡	ffln
郯	ffnl
灶	fg
尘	fg
少	fh
煌	fhag
燠	fhbk
省	fhbu
燔	fhdw
烽	fhej
烙	fher
烀	fhfd
熘	fhhw
煅	fhje
劣	fhks
熄	fhup
烁	fhvd
炉	fis
煸	fisb
煽	fism
熔	fjcr
烤	fjks
煊	fjmm
烷	fjmu
烧	fjpu
煳	fjrb
尖	fk
瞥	fkbu
燎	fkcf
尜	fkf
氅	fkhqu
烯	fkkb
鳖	fknwm
憋	fkp
蹩	fkryo
弊	fkt
炼	fkvc
烛	flmi
焖	flsp
烦	fmbo
兴	fmc
焐	fmmr
灯	fmn
炳	fmob
炻	fmr
光	fmu
焕	fnbk
焰	fnhx
炊	fno
烃	fnom
炀	fnsh
雀	fog
焓	foir
烩	fomi
烨	fopj
炸	fos
炝	fosu
灼	fpi
炮	fpru
炖	fpu
半	fq
眷	fqbu
桊	fqd
叛	fqhe
判	fqln
豢	fqmso
鲞	fqnwm
拳	fqq
炜	fqs
券	fqsh
卷	fqsu
粼	fqvv
誊	fqymr
炽	frc
燥	frrd
当	fsm
熠	fsma
烬	fsoy
炬	fss
烘	ftc
煤	ftmd
烂	ftmm
烊	ftq
灿	fu
辉	fubkq
耀	fusmg
数	fvok
烟	fwk
煨	fwmv
焯	fyaj
煺	fyav
熵	fycb
炷	fyg
炕	fyhn
燧	fyto
焙	fytr
炫	fyvi
土	g
埘	gadi
声	gah
坦	gam
堤	gamo
埸	gaph
塌	gasm
垠	gav
墁	gawe
冉	gb
堋	gbb
埒	gbdi
壳	gbhn
觳	gbhne
悫	gbhp
垌	gbmr
壹	gbmt
坝	gbo
壶	gbtc
坍	gby
赫	gcglc
赭	gcjka
郝	gcnl
赦	gcok
赧	gcsle
丧	gcv
增	gcwa
啬	gcwr
坡	gdhe
寺	gdi
块	gdk
瞽	gebu
墚	gecd
馨	gehda
鼙	gehwj
磬	gemr
罄	geoju
謦	geymr
款	gfno
圭	gg
墙	ggcw
封	ggdi
恚	ggp
卦	ggy
垧	ghbr
坂	ghe
圻	ghml
垢	ghmr
甏	ghmvn
坼	ghmy
垛	ghnd
埠	ghrj
坻	ghvi
埤	ghwj
去	gi
圹	gi
盍	gibt
城	gihs
埔	gijb
垅	gikp
劫	giks
墉	gilb
塘	gilr
埃	giok
域	girm
却	gisl
填	gjbc
埴	gjbm
堵	gjka
垸	gjmu
坨	gjp
熬	gkf
螫	gklmi
埯	gklu
垮	gkms
埭	gle
圳	glll
赤	glnc
坤	glwl
垣	gmam
圩	gmd
坏	gmf
坪	gmfj
坯	gmfm
塬	gmhf
垤	gmig
坜	gmks
埂	gmlk
坛	gmmi
圬	gmms
坷	gmnr
塥	gmrb
垭	gmtc
堙	gmwg
堍	gnai
圾	gnhe
彀	gnhne
埏	gnkv
坎	gno
场	gnsh
趄	gobm
趟	gofbr
堆	gog
趱	gohuo
趑	goimo
埝	goip
越	goiv
赵	gok
堠	golk
赶	gomj
趔	gomnn
圪	gon
趋	gonsm
趁	goohh
超	goshr
趣	gosje
起	gosu
赳	govl
赴	goy
志	gp
地	gpd
均	gpim
堞	gptd
坞	gpvm
毂	gqhne
吉	gr
埙	grbo
袁	grhv
颉	grmbo
埕	grmg
埚	grob
熹	grtf
喜	grtr
嘉	grtr
圯	gru
堰	gsav
墀	gseq
埽	gsmb
坭	gsp
圮	gsu
堀	gsuu
彭	gthhh
懿	gtiop
幸	gtj
鼓	gtje
坩	gtm
堪	gtmv
塔	gtor
垲	gusu
坳	gvis
埋	gwg
塄	gwls
坶	gwyi
盐	gybt
墒	gycb
墩	gydk
坑	gyhn
坊	gyhs
坟	gyk
址	gylm
走	gyo
墟	gypc
坫	gyr
壕	gyro
壤	gyrv
垆	gys
垃	gyt
培	gytr
境	gytu
垴	gyuk
垓	gyvo
竹	h
丿	h
白	ha
泉	hae
皤	hahdw
皈	hahe
皓	hahgr
魄	hahui
皖	hajmu
皋	hakj
帛	halb
笪	ham
皇	hamg
馥	haoae
皂	hap
的	hapi
笆	hau
皑	hausu
簋	havt
皎	hayck
爨	hbddf
笕	hbhu
奥	hbk
筋	hbks
制	hbln
璺	hbmgi
筒	hbmr
向	hbr
血	hbt
自	hbu
纂	hbuf
篡	hbui
算	hbut
农	hbv
舟	hbyi
箪	hcwj
禾	hd
香	hda
策	hdb
稠	hdbgr
稻	hdbhx
租	hdbm
稃	hdbnd
箱	hdbu
税	hdcru
秣	hddj
释	hdeq
秋	hdf
稍	hdfb
秒	hdfh
穑	hdgcw
秸	hdgr
穆	hdhah
秃	hdhn
秩	hdhqo
稗	hdhwj
私	hdi
稂	hdiav
秫	hdid
稽	hdiua
嵇	hdiuu
稹	hdjbc
穗	hdjip
稼	hdjmo
稀	hdkkb
种	hdl
秉	hdl
秧	hdlbk
利	hdln
剁	hdln
籁	hdlo
簌	hdlo
乘	hdlp
釉	hdlw
秭	hdlxh
笨	hdm
秤	hdmfj
秆	hdmj
季	hdnd
称	hdnf
秀	hdnhs
移	hdnin
邾	hdnl
稳	hdnsp
黍	hdoe
稚	hdog
稔	hdoip
悉	hdp
秘	hdph
秕	hdpp
和	hdr
积	hdrc
程	hdrmg
稆	hdrr
秽	hduni
委	hdv
番	hdw
稷	hdwce
稞	hdwd
科	hdyj
稿	hdyrb
穰	hdyrv
反	he
夂	he
条	hed
箔	heha
簿	heii
务	heks
磐	hemr
各	her
备	hew
处	hey
冬	hey
黏	heyr
筲	hfb
乎	hfd
篓	hfdv
愁	hfp
壬	hg
等	hgdi
熏	hgf
先	hghu
丢	hgi
筠	hgpm
告	hgr
靠	hgrly
篁	hhag
卿	hhail
贸	hhbo
射	hhdi
躺	hhfbr
筅	hhgu
彡	hhh
躲	hhhnd
笑	hhk
笊	hhlo
须	hhmbo
躬	hhn
黎	hhoe
笙	hhqm
笔	hhqu
躯	hhsk
卯	hhsl
孵	hhsld
卵	hhsli
篼	hhvu
留	hhw
黧	hhwgf
篦	hhwp
篪	hhyn
么	hi
魍	hibtv
魈	hifb
箴	hihr
魃	hiike
笺	hij
魅	hijd
笼	hikp
魉	himob
邸	hinl
乏	hino
鹅	hipym
鸱	hipym
笞	hir
篇	hisb
簏	hixp
魁	hiyj
魑	hiyub
千	hj
质	hjbo
盾	hjbu
箜	hjcm
朱	hjd
段	hjhne
箸	hjka
乖	hjlp
郫	hjnl
箢	hjnu
鹎	hjpym
舌	hjr
管	hjrr
翱	hjsmm
垂	hjtm
重	hjwg
夭	hk
乔	hkll
吞	hkr
笳	hksr
岙	hku
亻	hl
币	hlb
禹	hlbi
齄	hldam
篮	hlit
鼽	hlkn
筛	hllb
劓	hlln
颀	hlmbo
鼾	hlmj
篑	hlmo
欣	hlno
爪	hlo
简	hlsa
笃	hlvm
笛	hlw
箫	hlx
笫	hlxh
眚	hmbu
竽	hmd
筑	hmhn
毁	hmhne
竿	hmj
斤	hml
筻	hmlk
竺	hmm
筇	hmnl
筮	hmoo
惩	hmp
后	hmr
卮	hmsu
笄	hmt
簪	hmua
篥	hmwd
簟	hmwj
甥	hmwks
斥	hmy
几	hn
飓	hnbmc
朵	hnd
梨	hnd
殳	hne
凤	hne
飚	hnfff
凰	hnhag
笈	hnhe
犁	hnhq
飕	hnhxe
凡	hni
风	hnk
筵	hnkv
第	hnlh
颓	hnmbo
夙	hnmni
簦	hnot
愆	hnp
飑	hnpru
掣	hnq
筝	hnsd
八	ho
彳	ho
得	hoami
爬	hoau
很	hoav
衢	hobgn
徂	hobm
徭	hobou
衔	hocmn
彼	hodhe
符	hodi
徕	hodt
衍	hoemn
徜	hofbr
待	hogdi
街	hoggn
徒	hogyo
徨	hohag
循	hohju
役	hohne
瓞	hohqo
徼	hohsk
筏	hoi
德	hojwp
篌	holk
筱	holk
徘	holmy
律	holq
筌	homg
签	homm
行	hommn
答	homr
衙	homrn
征	homym
衡	honkn
径	honom
徐	hoomd
御	hooml
徇	hopa
彻	hopsh
笮	hos
徉	hotq
徽	houfk
徵	hougk
微	houuk
後	hovie
徊	howr
往	hoyg
彷	hoyhs
徙	hoylo
乇	hp
昏	hpa
筷	hpdk
笏	hphh
剩	hpln
筚	hppj
笱	hpr
印	hpsl
牛	hq
筢	hqau
犋	hqbmc
看	hqbu
掰	hqchq
籍	hqda
牡	hqg
特	hqgdi
牿	hqhgr
牲	hqhqm
牦	hqhqu
籀	hqhw
我	hqi
犏	hqisb
犊	hqjnk
牯	hqjr
筹	hqki
犄	hqkmr
生	hqm
箐	hqmb
牺	hqmcw
牾	hqmmr
箦	hqmo
拜	hqmqj
犍	hqnkq
失	hqo
牧	hqok
搿	hqorq
牝	hqp
物	hqphh
筘	hqr
箍	hqsb
箝	hqtm
毛	hqu
犒	hqyrb
舐	hrhvp
阜	hrj
刮	hrln
舔	hrmkp
郜	hrnl
雒	hrog
敌	hrok
鸹	hrpy
鹄	hrpym
甜	hrtm
乱	hru
辞	hrytj
勹	hs
所	hshml
殷	hshne
笤	hshr
笋	hsk
箧	hskt
篚	hsly
筐	hsmg
笥	hsmr
敫	hsok
笸	hsr
升	ht
箭	htbn
簸	htce
衅	htfq
箬	htkr
簧	htlc
箕	htmc
衄	htng
篝	httb
赞	hubo
臬	hud
毯	huff
毳	huhuu
鬼	hui
毪	huihq
臭	huik
毽	hunkq
氇	hunwa
息	hup
憩	hup
氆	hutca
鼻	huwml
毡	huyr
鼹	hvajv
鼷	hvbvk
鼢	hvcsh
乐	hvd
簖	hvdl
兜	hvhu
魏	hvhui
系	hvif
瓜	hvio
鼬	hvlw
鼯	hvmmr
篆	hvno
氏	hvp
氐	hvpi
卑	hwhj
囟	hwk
篾	hwli
箩	hwln
箅	hwml
粤	hwmvs
囱	hwni
鄱	hwnl
惫	hwp
翻	hwsmm
臼	hx
盥	hxbt
身	hxh
舆	hxkc
叟	hxle
歃	hxno
臾	hxo
舄	hxpf
舁	hxt
鼠	hxvyv
舅	hxwks
忄	hy
昝	hya
舰	hybhu
盘	hybt
艄	hyfb
舶	hyha
舨	hyhe
篷	hyhj
般	hyhne
船	hyhnr
艘	hyhxe
舣	hyik
舵	hyjp
笾	hyks
舯	hyl
螽	hylii
舳	hylw
舡	hym
舾	hymcw
舸	hymnr
艋	hyndt
艇	hynkg
舴	hyos
舱	hyosu
舭	hypp
咎	hyr
篙	hyrb
艉	hyshu
簇	hysk
笠	hyt
艨	hytbo
艏	hythu
艚	hytwa
舢	hyu
篱	hyub
航	hyyhn
舫	hyyhs
舻	hyys
艟	hyytg
舷	hyyvi
戈	i
丶	i
良	iav
宀	ib
能	ibpp
翩	ibsmm
术	id
床	id
麻	idd
糜	iddd
縻	iddf
麽	iddi
魔	iddi
摩	iddq
磨	iddr
麾	iddu
靡	iddy
书	ids
昶	iea
皴	iedhe
救	ieok
裘	ieyhv
视	ifbhu
祖	ifbm
禅	ifcwj
社	ifg
祛	ifgi
禧	ifgrr
祈	ifhml
祗	ifhvi
祓	ifike
祜	ifjr
禄	iflme
祧	iflmo
神	iflwl
应	ifm
祆	ifmk
福	ifmrw
祢	ifnf
祁	ifnl
祚	ifos
鹧	ifpym
禊	ifqhk
祝	ifrhu
祸	ifrob
祀	ifru
蹙	ifryo
祠	ifsmr
禚	iftgf
祺	iftmc
祥	iftq
礼	ifu
祯	ifybo
祉	ifylm
禳	ifyrv
庄	ig
戊	ih
毵	ihhqu
戍	ihi
戌	ihm
咸	ihmr
威	ihmv
牟	ihq
成	ihs
允	ihu
底	ihvi
庳	ihwj
庾	ihxo
戚	ihymf
朗	iib
垒	iiig
灬	iiii
廊	iiil
庞	iikp
疒	iim
氵	iim
郎	iinl
庐	iis
废	iive
戎	ij
戋	ij
甫	ijb
盏	ijbt
求	ije
庋	ije
义	ik
庆	ik
犬	ik
参	ikhhh
飙	ikhnk
肇	iklq
庵	iklu
叁	ikmmm
龙	ikp
库	ikq
为	iksi
尤	iku
綮	ikvif
畚	ikw
庸	ilb
康	ile
州	ilil
划	iln
庚	ilo
赓	iloo
唐	ilr
庙	ilw
冫	im
亠	im
凋	imbgr
凇	imdci
决	imdk
冰	ime
凌	imgce
冼	imhgu
减	imihr
冶	imir
凄	imjlv
冻	imkd
庑	imku
冲	iml
冯	imlvm
冽	immnn
冱	immvm
次	imno
净	imnsd
准	imog
冷	imoii
惑	imp
凝	impko
凑	imqkk
况	imrhu
臧	imsll
凛	imywf
廨	inbq
永	ine
序	inin
庭	inkg
邝	inl
衤	inlo
辶	inno
之	ino
讠	inv
礻	iny
资	iobo
盗	iobt
庥	iod
府	iodi
粢	iofd
膺	iogb
鹰	iogm
腐	ioib
矣	iok
瓷	iomvn
座	ioog
恣	iop
咨	ior
姿	iov
弋	ip
庀	ip
鏖	ipc
熊	ipf
麋	ipfd
麟	ipfdq
垄	ipg
麇	iphd
麝	iphhi
麂	iphn
式	ipm
贰	ipmmo
砻	ipmr
庇	ipp
忒	ipp
鸢	ippym
庖	ipru
聋	ipsj
龚	iptc
甙	iptm
麒	iptmc
黛	ipwgf
麈	ipyg
袭	ipyhv
廒	iqsk
台	ir
扈	irau
炱	irf
或	irm
邰	irnl
感	irp
怠	irp
户	is
肩	isb
扃	isbr
盛	isbt
扁	isbt
戾	isik
扉	islmy
廖	ismh
雇	isog
敷	isok
启	isr
扇	issmm
房	isyhs
戽	isyj
戒	it
弁	it
度	ite
庶	itf
席	itlb
廑	itlm
庠	itq
庹	itso
廉	itxc
谒	ivapv
谩	ivawe
调	ivbgr
诨	ivbkq
诅	ivbm
谖	ivbme
谣	ivbou
讼	ivci
说	ivcru
讨	ivdi
诀	ivdk
谏	ivdwf
译	iveq
诮	ivfb
谠	ivfbu
谈	ivff
诗	ivgdi
诖	ivgg
诘	ivgr
诱	ivhds
诿	ivhdv
诰	ivhgr
诜	ivhgu
谢	ivhhi
诛	ivhjd
话	ivhjr
诟	ivhmr
诉	ivhmy
讥	ivhn
设	ivhne
讽	ivhnk
诋	ivhvi
谀	ivhxe
诚	ivihs
议	ivik
诶	iviok
谘	ivior
试	ivipm
诒	ivir
谝	ivisb
诫	ivit
计	ivj
谳	ivjbk
谊	ivjbm
诧	ivjhp
诸	ivjka
读	ivjnk
诂	ivjr
发	ivke
诙	ivkf
诳	ivkhg
训	ivlll
蚀	ivlmi
诽	ivlmy
谰	ivlsw
讧	ivm
评	ivmfj
讦	ivmj
语	ivmmr
订	ivmn
诃	ivmnr
诬	ivmoo
诼	ivmso
谮	ivmua
讶	ivmvh
谭	ivmwj
证	ivmym
谵	ivncr
谲	ivnhb
谄	ivnhx
诵	ivnib
讯	ivnj
诞	ivnkv
诡	ivnmu
诤	ivnsd
诌	ivnsm
谗	ivnuy
认	ivo
讷	ivob
谁	ivog
谯	ivogf
诊	ivohh
谶	ivoim
谂	ivoip
许	ivoj
诠	ivomg
谕	ivomn
讫	ivon
论	ivop
讹	ivop
诈	ivos
诲	ivowy
询	ivpa
诣	ivpa
谧	ivpht
谐	ivppa
谍	ivptd
诔	ivqd
请	ivqmb
讳	ivqs
识	ivrc
误	ivrmk
谔	ivrrs
诏	ivshr
诹	ivsje
讴	ivsk
诓	ivsmg
谬	ivsmh
诩	ivsmm
词	ivsmr
讵	ivss
记	ivsu
谟	ivtak
谫	ivtbh
谱	ivtca
谥	ivtct
诺	ivtkr
谨	ivtlm
谋	ivtmd
谌	ivtmv
详	ivtq
讲	ivtt
谦	ivtxc
谎	ivtyu
讪	ivu
诎	ivuu
谓	ivwb
谡	ivwce
课	ivwd
讣	ivy
谛	ivybb
谤	ivybs
谪	ivycb
谜	ivyfd
谚	ivyhh
访	ivyhs
谴	ivylr
让	ivym
谇	ivyoj
谑	ivypm
谆	ivyrd
谅	ivyrf
谙	ivyta
该	ivyvo
廛	iwcg
鹿	ixp
廓	iydl
店	iyr
廪	iywf
十	j
煮	jaf
都	janl
翥	jasmm
宴	jav
赍	jbbo
献	jbik
宜	jbm
真	jbmc
直	jbmm
橐	jbmrd
蠹	jbmri
孛	jbnd
察	jbof
囊	jbrrv
南	jbtj
索	jbvif
穴	jc
窭	jcfdv
窖	jchgr
窆	jchio
窳	jchoo
窗	jchwk
突	jcik
窦	jcjnk
究	jckn
穷	jcks
帘	jclb
窜	jcll
窕	jclmo
空	jcm
颠	jcmbo
窒	jcmig
窍	jcmms
穿	jcmvh
穹	jcn
穸	jcni
窿	jcnlm
窑	jcoju
窬	jcomn
容	jcor
窄	jcos
窃	jcpsh
窀	jcpu
窥	jcqou
窝	jcrob
窘	jcskr
窟	jcsuu
窈	jcvis
窠	jcwd
窨	jcyta
未	jd
宋	jd
守	jdi
勃	jdks
教	jdok
鹁	jdpym
支	je
墼	jeg
翅	jesmm
灾	jf
宵	jfb
客	jher
宪	jhgu
宅	jhp
牢	jhq
博	jibi
栽	jid
宠	jikp
载	jikq
截	jiog
惠	jip
哉	jir
戴	jiwtc
裁	jiyhv
艹	jj
廾	jj
朝	jjb
戟	jji
乾	jjon
翰	jjosm
斡	jjoyj
韩	jjqs
軎	jjr
丈	jk
者	jka
宥	jkb
觌	jkbhu
寮	jkcf
宏	jki
寄	jkmr
嫠	jkmv
考	jkmvs
宄	jkn
孝	jknd
老	jkp
协	jksc
吏	jlk
事	jlln
寝	jlme
妻	jlv
宙	jlw
审	jlwl
士	jm
宣	jmam
寡	jmch
宇	jmd
宝	jmgi
室	jmig
矗	jmjmm
寅	jmlc
宗	jmmf
完	jmmu
宸	jmmv
宁	jmn
宕	jmr
富	jmrw
家	jmso
寇	jmue
定	jmyo
字	jnd
宛	jniu
麴	jnpfd
卖	jnyk
宿	joma
宾	jomc
它	jp
耆	jpa
甯	jpbq
宓	jph
蜜	jphi
耄	jphqu
密	jphu
耋	jpmig
尧	jpmu
箨	jqeq
害	jqjr
古	jr
胡	jrb
鹕	jrbpm
豁	jrcor
克	jrhu
割	jrln
官	jrlr
额	jrmbo
故	jrok
鸪	jrpym
宫	jrr
嘏	jrrse
辜	jrytj
肀	js
宦	jsll
寥	jsmh
卉	jt
寞	jtak
贲	jtbo
宽	jtbu
寨	jtcd
塞	jtcg
骞	jtcm
赛	jtco
蹇	jtco
搴	jtcq
謇	jtcr
褰	jtcv
寒	jtcy
七	ju
兢	jujru
剜	juln
翘	jusmm
安	jv
案	jvd
寐	jvmd
寤	jvmr
寓	jwlb
寰	jwlv
寂	jyfe
实	jyk
宰	jytj
大	k
瘟	kabt
橥	kad
疸	kam
疤	kau
痕	kav
有	kb
牵	kbhq
郗	kbln
疽	kbm
郁	kbnl
欷	kbno
瘵	kbof
瘿	kbov
痈	kbq
癯	kbug
瘅	kcwj
东	kd
杀	kd
疲	kdhe
夺	kdi
弑	kdipm
刹	kdln
瘌	kdln
癞	kdlo
鸫	kdpym
友	ke
痧	kefh
瘙	keii
瘫	keog
灰	kf
盔	kfbt
瘠	kfcb
瘘	kfdv
痰	kff
鹩	kfpym
痔	kgdi
奎	kgg
痣	kgp
猖	khaa
猩	khahm
猸	khahu
狠	khav
猾	khbbb
狙	khbm
狈	khbo
猹	khdam
獭	khdlo
痢	khdn
痿	khdv
疼	khey
狄	khf
猿	khgrv
猁	khhdn
獯	khhgf
狐	khhvo
瘤	khhw
猊	khhxu
犷	khi
狼	khiav
狻	khice
狁	khihu
狨	khij
犹	khiku
狱	khivk
狩	khjdi
猪	khjka
狞	khjmn
猢	khjrb
獠	khkcf
猗	khkmr
犰	khkn
狭	khkt
狮	khllb
狒	khlln
独	khlmi
犸	khlvm
狂	khmg
犴	khmj
獗	khmto
獬	khnbq
狲	khndf
猛	khndt
疫	khne
狃	khng
猱	khnhd
疯	khnk
猕	khnnf
狰	khnsd
猴	kholk
狳	khomd
狯	khomi
猃	khomm
猞	khomr
狴	khppg
狗	khpr
狍	khpru
猜	khqmb
狷	khrb
犯	khsu
猎	khta
獾	khtrg
猫	khtw
瘪	khup
猬	khwb
猓	khwd
狸	khwg
狎	khwl
猡	khwln
猥	khwmv
瘦	khxe
瘐	khxo
狡	khyck
瘢	khye
狺	khymr
猝	khyoj
獐	khytj
獍	khytu
太	ki
疣	kiku
郄	kinl
雄	kiog
态	kip
癫	kjco
奢	kjka
奔	kjt
爻	kk
肴	kkb
爽	kkkk
希	kklb
痍	kkn
瘸	kkrb
夯	kks
痂	kksr
瘗	kktg
暂	kla
布	klb
錾	klc
椠	kld
在	klg
堑	klg
夼	klll
痱	klmy
刈	kln
存	klnd
痫	klsd
奄	klwu
左	km
痞	kmfr
癍	kmgg
疬	kmks
奈	kmmf
痦	kmmr
夸	kmms
疔	kmn
奇	kmnr
疴	kmnr
病	kmob
痘	kmrt
疠	kms
瘃	kmso
痖	kmtc
瘭	kmwf
症	kmym
九	kn
夷	kn
旭	kna
旮	kna
痪	knbk
杂	knd
犭	knh
丸	kni
痛	knib
癃	knlm
瘾	knlp
癣	knmq
疗	knn
疚	kno
痉	knom
鸠	knpym
疡	knsh
馗	knthu
疹	kohh
疾	kok
痴	kokr
瘊	kolk
疥	koll
痊	komg
疙	kon
痤	koog
痄	kos
疮	kosu
疱	kpru
车	kq
辊	kqapp
钥	kqb
辋	kqbtv
轰	kqee
辍	kqeee
辚	kqfdq
辕	kqgrv
辂	kqher
轷	kqhfd
轿	kqhkl
斩	kqhml
瘛	kqhp
轶	kqhqo
轹	kqhvd
辅	kqijb
轼	kqipm
辘	kqixp
辖	kqjqr
轱	kqjr
轨	kqkn
轴	kqlw
轾	kqmig
轩	kqmj
轲	kqmnr
辆	kqmob
辐	kqmrw
轭	kqmsu
软	kqno
轻	kqnom
轸	kqohh
辁	kqomg
输	kqomn
轮	kqop
辏	kqqkk
转	kqqni
轵	kqrc
辑	kqrsj
轫	kqshi
轺	kqshr
辄	kqsju
辗	kqstv
轧	kqu
辎	kqvvw
辙	kqybk
较	kqyck
轳	kqys
右	kr
贺	krbo
架	krd
剞	krln
驾	krlvm
哿	krmnr
欹	krno
癌	krru
瘕	krse
袈	kryhv
力	ks
办	ksc
癜	ksce
瓠	kshvo
耷	ksj
奁	ksk
疖	ksl
刳	ksln
疟	ksm
瘳	ksmh
套	ksmi
匏	kspru
加	ksr
癖	ksrj
勰	kswp
夹	kt
瘼	ktak
痨	ktbs
癀	ktlc
疳	ktm
颊	ktmbo
郏	ktnl
瘩	ktor
痒	ktq
瘥	ktqm
疝	ku
尢	ku
尴	kulit
尬	kuoll
尥	kupi
鹌	kupym
奋	kw
痼	kwjr
痹	kwml
瘰	kwvf
疰	kyg
疵	kymp
瘁	kyoj
瘀	kysy
瘴	kytj
癔	kytp
痃	kyvi
中	l
丨	l
旧	la
袒	lam
裼	laph
褐	lapv
裉	lav
巾	lb
帽	lbabu
幌	lbafu
幔	lbawe
帔	lbdhe
帕	lbha
幡	lbhdw
帆	lbhni
帙	lbhqo
央	lbk
幅	lbmrw
帷	lbog
帐	lbpo
帱	lbqki
帻	lbqmo
帏	lbqs
帜	lbrc
幄	lbsmg
盅	lbt
幞	lbtco
帼	lbwmi
帧	lbybo
帖	lbyr
幢	lbytg
幛	lbytj
裕	lcor
襟	lddf
襻	lddq
被	ldhe
衬	ldi
袜	ldj
袂	ldk
鹇	ldpym
隶	le
肾	leb
贤	lebo
裰	leee
坚	leg
衩	lei
剥	leln
紧	levif
竖	leyt
褛	lfdv
袢	lfq
裆	lfsm
褂	lggy
装	lgyhv
袼	lher
衽	lhg
衫	lhhh
袄	lhk
裨	lhwj
褫	lhyn
蜴	liaph
蝎	liapv
螟	libac
蜩	libgr
蚬	libh
览	libhu
蛆	libm
蜉	libnd
监	libt
蛊	libt
蠼	libue
鉴	lic
蚣	lici
蜕	licru
蝉	licwj
蜥	lidhl
蛏	lieg
蛸	lifb
螳	lifbg
蝼	lifdv
蜷	lifqu
蚺	ligb
蛙	ligg
蟛	ligth
蝗	lihag
蝌	lihdj
蜊	lihdn
蟋	lihdp
蟠	lihdw
蜂	lihej
蛛	lihjd
蛞	lihjr
虮	lihn
蛾	lihqi
蚝	lihqu
螅	lihup
蜱	lihwj
螋	lihxe
蛑	liihq
蚁	liik
螂	liil
螗	liilr
蜮	liirm
蝙	liisb
蠊	liitc
蝻	lijbj
蟪	lijip
蜿	lijnu
蛇	lijp
蛲	lijpu
蛄	lijr
蝴	lijrb
蝰	likgg
裤	likq
蛱	likt
蛳	lillb
蚂	lilvm
蚰	lilw
虹	lim
虹	lim
蠕	limbb
螈	limhf
蛭	limig
蛎	limms
蚵	limnr
蝠	limrw
蚜	limvh
螵	limwf
虾	limy
蟓	linao
蟾	lincr
蜢	lindt
蛹	linib
蜓	linkg
蜒	linkv
蚓	linl
蝮	lioae
蚋	liob
蛉	lioii
蜘	liokr
蚧	lioll
蚯	liom
蜍	liomd
蝓	liomn
蛤	liomr
虼	lion
蚱	lios
蚍	lipp
蝶	liptd
蚌	liqj
蝽	liqka
螓	liqkd
蜻	liqmb
蚨	liqo
蝇	lirlu
蜈	lirmk
蜗	lirob
褊	lisb
蜡	lita
蟆	litak
蝾	litbd
蠓	litbo
蝤	litcw
蜣	litgu
蟒	litit
蟥	litlc
蚶	litm
蜞	litmc
螨	litob
蠖	litoe
蛘	litq
蟮	littr
蛐	litw
螬	litwa
蠛	litwi
虬	liu
蚴	livis
蜾	liwd
蝈	liwmi
蛔	liwr
螺	liwvf
螃	liybs
蛟	liyck
蛀	liyg
蟀	liyij
蚪	liyj
蚊	liyk
蛴	liykl
蝣	liysd
蟑	liytj
螭	liyub
虻	liyv
褚	ljka
史	lk
盎	lkbt
鸯	lkpym
串	ll
版	llhe
牌	llhwj
牖	llisb
褴	llit
牍	lljnk
川	lll
帅	lllb
顺	lllo
师	llmb
片	llml
弗	lln
畅	llnsh
临	lloa
患	llp
褙	llpb
牒	llptd
裥	llsa
归	llsm
袖	llw
襦	lmbb
驵	lmbm
贵	lmbo
驭	lme
骚	lmeii
驿	lmeq
壮	lmg
骆	lmher
骝	lmhhw
骄	lmhkl
骢	lmhwp
虫	lmi
骏	lmice
状	lmik
骖	lmikh
骀	lmir
驴	lmis
骗	lmisb
骟	lmism
驼	lmjp
骁	lmjpu
驮	lmk
驳	lmkk
骑	lmkmr
驶	lmlk
驯	lmlll
骥	lmlpc
骋	lmlws
骊	lmmbb
录	lmme
骠	lmmwf
将	lmnii
驺	lmnsm
驸	lmodi
骓	lmog
验	lmomm
骅	lmopj
北	lmp
驰	lmpd
邶	lmpnl
驹	lmpr
骤	lmseo
驱	lmsk
骣	lmsnd
非	lmsy
骐	lmtmc
骈	lmtt
兆	lmuo
妆	lmv
褥	lmvi
驷	lmwc
骒	lmwd
骡	lmwvf
驻	lmyg
骇	lmyvo
刂	ln
冖	ln
费	lnbo
桨	lnd
浆	lne
奖	lnk
酱	lnmcw
艴	lnnau
襁	lnri
衲	lob
鼗	logte
袱	loik
衿	loin
裣	lomm
袷	lomr
褓	lord
忠	lp
背	lpb
袍	lpru
冀	lpwtc
聿	lq
祷	lqki
裱	lqmv
裎	lrmg
门	ls
冂	ls
间	lsa
阊	lsaa
阌	lsbbe
阒	lsbuk
阅	lscru
阐	lscwj
闲	lsd
闭	lsdh
阑	lsdw
阔	lsehr
闺	lsgg
阖	lsgit
初	lsh
阁	lsher
阍	lshpa
阋	lshxu
阆	lsiav
阈	lsirm
阗	lsjbc
裾	lsjr
闳	lski
阉	lsklu
裙	lskr
闽	lslmi
闯	lslvm
闩	lsm
褶	lsma
闰	lsmg
韭	lsmm
闫	lsmmm
阎	lsnhx
阚	lsnjk
阕	lsnok
阄	lsnwu
闪	lso
阀	lsoi
闷	lsp
闱	lsqs
问	lsr
闾	lsrr
闻	lssj
阙	lstuo
阃	lswd
闸	lswl
闶	lsyhn
闵	lsyk
闼	lsyk
闹	lsylb
阏	lsysy
阂	lsyvo
褡	ltor
儿	lu
鸩	lupym
胤	lvbu
马	lvsm
由	lw
胄	lwb
裸	lwd
申	lwl
邮	lwnl
曳	lwp
电	lwu
肃	lx
补	ly
褪	lyav
辈	lykq
裢	lykq
蜚	lylmi
悲	lyp
翡	lysmm
裴	lyyhv
斐	lyyk
一	m
百	ma
戬	mai
厩	maiu
亘	mam
碧	mamr
厚	mand
霾	mbbhg
霜	mbdbu
霖	mbdd
耐	mbdi
霪	mbebg
霈	mbeyb
霄	mbfb
雾	mbhes
霓	mbhxu
丽	mbib
霭	mbivv
而	mbll
融	mblmi
霏	mblmy
需	mbmbl
颥	mbmbo
雳	mbmks
雩	mbmms
震	mbmmv
霆	mbnkg
邴	mbnl
郦	mbnl
页	mbo
贡	mbo
霍	mbog
零	mboii
厕	mbon
霉	mbowy
恧	mbp
雹	mbpru
鸸	mbpy
鹂	mbpym
露	mbrmr
霞	mbrse
雪	mbsm
翮	mbsmm
霹	mbsrj
霰	mbtbk
霸	mbtjb
耍	mbv
雷	mbw
雯	mbyk
霁	mbykl
霎	mbytv
晋	mca
垩	mcg
恶	mcp
西	mcw
酉	mcwm
于	md
盂	mdbt
厢	mdbu
五	mdm
汞	me
不	mf
灭	mf
甭	mfbq
飘	mfhnk
瓢	mfhvo
平	mfj
剽	mfln
丕	mfm
歪	mfmym
鄢	mfnl
愿	mfp
否	mfr
孬	mfvnd
王	mg
瑁	mgabu
琨	mgapp
琶	mgau
再	mgb
瑷	mgbbe
珊	mgbbm
琛	mgbcd
现	mgbhu
珲	mgbkq
瑗	mgbme
瑶	mgbou
璎	mgbov
玢	mgcsh
琳	mgdd
玻	mgdhe
琐	mgfbo
琰	mgff
珐	mggi
珀	mgha
珞	mgher
珠	mghjd
玑	mghn
珩	mghon
瑰	mghui
瓒	mghuo
璁	mghwp
压	mgi
玉	mgi
琅	mgiav
球	mgije
珑	mgikp
班	mgilg
瑭	mgilr
琮	mgjmf
琬	mgjnu
瑚	mgjrb
琦	mgkmr
珈	mgksr
珧	mglmo
到	mgln
玛	mglvm
顼	mgmbo
环	mgmf
珏	mgmgi
琊	mgmhl
玩	mgmmu
玎	mgmn
珂	mgmnr
琢	mgmso
甄	mgmvn
鄄	mgnl
郅	mgnl
玖	mgno
珍	mgohh
玲	mgoii
玲	mgoii
琴	mgoin
玳	mgoip
致	mgok
玫	mgok
瑜	mgomn
瑟	mgph
琵	mgpp
臻	mgqkd
玮	mgqs
璐	mgrmr
噩	mgrr
瑕	mgrse
珉	mgrvp
珥	mgsj
琚	mgsjr
弄	mgt
珙	mgtc
璞	mgtco
璜	mgtlc
瑛	mgtlk
瑾	mgtlm
琪	mgtmc
瑞	mgumb
璀	mguog
瑙	mgvvw
理	mgwg
璨	mgyed
琉	mgyiu
玟	mgyk
斑	mgykg
琏	mgykq
琥	mgypn
璩	mgypo
玷	mgyr
琼	mgyrf
璇	mgyso
璋	mgytj
璃	mgyub
厂	mh
原	mhaf
巩	mhni
邪	mhnl
雅	mhog
餮	mhoiv
鸦	mhpym
至	mig
魂	mihui
厌	mik
魇	miki
厣	mikl
动	miks
餍	mikv
靥	mikw
干	mj
刊	mjln
顸	mjmbo
邗	mjnl
天	mk
蚕	mklmi
忝	mkp
厍	mkq
功	mks
历	mks
无	mku
丌	ml
雨	mlby
工	mlm
更	mlwk
二	mm
项	mmbo
示	mmf
云	mmi
亓	mml
三	mmm
辰	mmmv
厅	mmn
亍	mmn
邳	mmnl
政	mmok
鹉	mmpym
吾	mmr
厉	mms
厨	mmti
元	mmu
厦	mmue
鼋	mmuu
巧	mmvs
亏	mmvs
丁	mn
殂	mnbm
殍	mnbnd
銎	mnc
殚	mncwj
烈	mnf
型	mng
殪	mngbt
歼	mnhj
殊	mnhjd
殁	mnhne
歹	mni
残	mnij
殆	mnir
殖	mnjbm
殡	mnjoc
邛	mnl
殃	mnlbk
蛩	mnlmi
列	mnln
顶	mnmbo
殛	mnnem
殄	mnohh
殓	mnomm
殇	mnonh
死	mnp
恐	mnp
殉	mnpa
可	mnr
殒	mnrbo
跫	mnryo
裂	mnyhv
仄	mo
丙	mob
觋	mobhu
燹	mof
赝	mogo
攻	mok
劂	moln
巫	moo
两	moob
雁	moog
武	mpylm
石	mr
碍	mrami
碣	mrapv
硼	mrbb
碉	mrbgr
砚	mrbhu
鬲	mrbl
硐	mrbmr
碴	mrdam
破	mrdhe
泵	mre
磉	mreed
磲	mresd
硝	mrfb
磷	mrfdq
砂	mrfh
硅	mrgg
砝	mrgi
磕	mrgit
硌	mrher
砭	mrhio
斫	mrhml
矶	mrhn
矾	mrhni
砜	mrhnk
硪	mrhqi
砾	mrhvd
砥	mrhvi
碑	mrhwj
硇	mrhwk
矿	mri
碱	mrihr
碜	mrikh
碥	mrisb
碹	mrjmm
碇	mrjmo
碗	mrjnu
砣	mrjp
硗	mrjpu
砗	mrkq
硖	mrkt
砩	mrlln
碌	mrlme
码	mrlvm
砷	mrlwl
硕	mrmbo
硒	mrmcw
砰	mrmfj
矸	mrmj
硬	mrmlk
砺	mrmms
磊	mrmrr
研	mrmt
硎	mrmtn
砑	mrmvh
礓	mrmwm
确	mrnbq
矽	mrni
酃	mrnl
砍	mrno
歌	mrno
磴	mrnot
磔	mrnqd
哥	mrnr
砀	mrnsh
碓	mrog
礁	mrogf
砼	mrom
硷	mromm
砟	mros
砒	mrpp
砌	mrpsh
碟	mrptd
砘	mrpu
碛	mrqmo
碡	mrqmy
砖	mrqni
砸	mrslb
碾	mrstv
豆	mrt
碘	mrtbc
礤	mrtbf
礞	mrtbo
礴	mrtei
砹	mrtk
磺	mrtlc
磋	mrtqm
碰	mrttc
磁	mrtvi
硭	mrtyv
碳	mrukf
础	mruu
碲	mrybb
磅	mrybs
磙	mrycv
礅	mrydk
硫	mryiu
碎	mryoj
砧	mryr
砬	mryt
碚	mrytr
万	ms
豕	msho
励	msks
劢	msks
虿	mslmi
趸	msryo
厄	msu
开	mt
厝	mta
亚	mtc
严	mtch
厮	mtcl
形	mthhh
豉	mtje
豌	mtjnu
刑	mtln
豇	mtm
邢	mtnl
厥	mtuo
兀	mu
夏	muhe
戛	mui
虺	mulmi
顽	mumb
顾	mumbo
画	muw
匚	mv
牙	mvdh
辱	mvdi
蜃	mvlmi
瓦	mvni
互	mvnm
唇	mvr
醒	mwahm
覃	mwaj
醍	mwamo
醌	mwapp
酹	mwbdi
酮	mwbmr
贾	mwbo
酚	mwcsh
栗	mwd
酎	mwdi
粟	mwfd
厘	mwg
酥	mwhd
酪	mwher
醺	mwhgf
酷	mwhgr
酰	mwhgu
酐	mwhj
覆	mwhoe
酿	mwiav
酸	mwice
酬	mwill
醣	mwilr
酵	mwjkd
酡	mwjp
酤	mwjr
醐	mwjrb
酞	mwki
醢	mwkrt
副	mwln
酾	mwmbb
票	mwmmf
酝	mwmmi
酊	mwmn
酽	mwmth
酩	mwnir
醑	mwnob
醮	mwogf
酴	mwomd
酢	mwos
酶	mwowy
酯	mwpa
酏	mwpd
酌	mwpm
酲	mwrmg
面	mwsl
醪	mwsmh
配	mwsu
醋	mwta
醭	mwtco
酣	mwtm
醛	mwtog
醴	mwtwt
酗	mwuk
要	mwv
醚	mwyfd
醯	mwyit
醉	mwyoj
醵	mwypo
醇	mwyrd
醅	mwytr
下	my
焉	mylf
正	mylm
忑	myp
丐	myvs
弓	n
兔	nahi
免	nahu
象	napo
色	nau
觯	nbcwj
觖	nbdk
觫	nbdl
觥	nbfmu
堕	nbg
觚	nbhvo
奂	nbk
勇	nbks
触	nblmi
负	nbo
觞	nbonh
隳	nbop
恿	nbp
鹬	nbpym
角	nbq
解	nbshq
斛	nbyj
小	nc
弹	ncwj
詹	ncymr
子	nd
孟	ndbt
孙	ndf
孤	ndhvo
孺	ndmbb
孜	ndok
孢	ndpru
孔	ndu
孩	ndyvo
亟	nem
丞	nem
卺	nemsu
尔	nf
粥	nfdn
玺	nfmgi
丑	ng
疆	ngmwm
柔	nhd
及	nhe
虱	nhli
蟊	nhlii
骘	nhlvm
矜	nhoin
乃	nhs
弧	nhvo
夕	ni
弘	ni
甬	nibq
犟	nihq
夤	nijmc
矛	ninh
多	nini
予	ninn
飧	nioiv
舛	niq
名	nir
外	niy
敢	njok
又	nk
瞀	nkbu
鍪	nkc
煞	nkf
廷	nkhg
延	nkhyv
蝥	nklmi
建	nklq
骛	nklvm
憨	nkp
鹜	nkpym
婺	nkv
引	nl
阝	nl
阳	nla
陧	nlag
限	nlav
隰	nlavf
阴	nlb
阻	nlbm
陂	nldhe
隙	nlfaf
陵	nlgce
陡	nlgyo
隍	nlhag
阪	nlhe
隆	nlhem
降	nlheq
阡	nlhj
陲	nlhjm
隗	nlhui
陴	nlhwj
陇	nlikp
院	nljmu
陀	nljp
陈	nlkd
隋	nlkmb
阵	nlkq
陕	nlkt
陌	nlma
陋	nlmbv
际	nlmmf
阮	nlmmu
阿	nlmnr
隔	nlmrb
阢	nlmu
陷	nlnhx
陉	nlnom
隐	nlnsp
队	nlo
附	nlodi
阶	nloll
除	nlomd
险	nlomm
阼	nlos
陶	nlpou
陛	nlppg
陆	nlqu
陨	nlrbo
陬	nlsje
隘	nltct
阱	nltt
隅	nlwlb
隈	nlwmv
防	nlyhs
随	nlykb
陟	nlylh
阽	nlyr
障	nlytj
隧	nlyto
陪	nlytr
陔	nlyvo
鲳	nmaa
鲥	nmadi
鲫	nmail
弼	nman
鲲	nmapp
鳎	nmasm
鳗	nmawe
鲷	nmbgr
鳐	nmbou
鳋	nmeii
鳞	nmfdq
鲮	nmgce
鲑	nmgg
鲒	nmgr
鳇	nmhag
稣	nmhd
鳅	nmhdf
鲦	nmhed
鲧	nmhvf
鲵	nmhxu
鲅	nmike
鱿	nmiku
鳙	nmilb
鲐	nmir
鳊	nmisb
鲩	nmjmu
鳍	nmjpa
鲼	nmjto
鲔	nmkb
劲	nmks
鲣	nmleg
鲱	nmlmy
刭	nmln
鲡	nmmbb
鲕	nmmbl
颈	nmmbo
鳕	nmmbs
鲆	nmmfj
鲠	nmmlk
鳜	nmmto
鳔	nmmwf
鲺	nmnhi
弱	nmnim
鳆	nmoae
鲋	nmodi
鲶	nmoip
鲍	nmpru
鲽	nmptd
鲭	nmqmb
鳄	nmrrs
鲰	nmsje
鲟	nmsmi
危	nmsu
鳓	nmtjs
鲜	nmtq
鳝	nmttr
鳟	nmtwi
鳢	nmtwt
鲻	nmvvw
鲤	nmwg
鲴	nmwjr
鳏	nmwlf
鳃	nmwp
鲛	nmyck
鲂	nmyhs
巯	nmyi
疏	nmyiu
鲚	nmykl
鲢	nmykq
鲇	nmyr
鲸	nmyrf
鲈	nmys
了	nn
弥	nnf
廴	nnk
孑	nnm
预	nnmbo
鬻	nnmrb
豫	nnnao
孓	nno
弪	nnom
承	nnqo
欠	no
久	no
飞	no
胥	nob
灸	nof
坠	nog
蛋	nolmi
癸	nomk
登	nomrt
弛	npd
张	npo
桀	nqd
蟹	nqlmi
强	nrli
盈	nsbt
鼐	nsbul
争	nsd
皱	nsdhe
尕	nsf
弭	nsj
刍	nsm
孕	nsnd
邹	nsnl
雏	nsog
急	nsp
凳	nthn
戤	nti
勐	ntks
乙	nu
眢	nubu
勉	nuks
怨	nup
鸳	nupym
饣	nv
馄	nvapp
馒	nvawe
馁	nvbv
馇	nvdam
饷	nvhbr
饭	nvhe
饪	nvhg
馏	nvhhw
饫	nvhk
饥	nvhn
饿	nvhqi
馊	nvhxe
饯	nvij
饴	nvir
饽	nvjbd
馕	nvjbv
饶	nvjpu
馆	nvjrr
馈	nvlmo
馅	nvnhx
饮	nvno
饧	nvnsh
馋	nvnuy
饬	nvoks
饰	nvolb
馀	nvomd
饩	nvomn
饱	nvpru
饨	nvpu
馔	nvruc
饵	nvsj
饲	nvsmr
馍	nvtak
馓	nvtbk
馑	nvtlm
馐	nvtqg
饼	nvtt
饺	nvyck
鱼	nwm
鲁	nwma
龟	nwu
买	nyk
疋	nyo
弦	nyvi
人	o
倡	oaa
复	oahe
但	oam
偈	oapv
内	ob
倜	obgr
俱	obmc
侗	obmr
俘	obnd
肉	obo
傺	obof
侧	obon
佣	obq
佾	ocb
俗	ocor
份	ocsh
僧	ocwa
休	od
叙	ode
煲	odf
堡	odg
付	odi
体	odm
鸺	odpm
斜	odyj
仅	oe
氽	oe
氽	oe
傩	oeog
伙	of
俏	ofb
偿	ofbi
倘	ofbr
傥	ofbu
籴	ofd
偻	ofdv
伞	ofj
劁	ofln
您	ofp
鹪	ofpym
伴	ofq
倦	ofqu
仕	og
隹	og
赁	ogbo
集	ogd
侍	ogdi
焦	ogf
佳	ogg
凭	oghn
雠	ogivg
隼	ogj
隽	ognhs
恁	ogp
鹤	ogpym
售	ogr
佶	ogr
僖	ogrr
入	oh
伯	oha
侬	ohbv
傻	ohce
俐	ohdn
倭	ohdv
佟	ohey
任	ohg
仫	ohi
仟	ohj
侨	ohkl
仉	ohn
佩	ohnb
件	ohq
俄	ohqi
佚	ohqo
傀	ohui
低	ohvi
仰	ohvl
俾	ohwj
倪	ohxu
伐	oi
食	oiav
傅	oibi
俊	oice
垡	oig
侔	oihq
俅	oije
伏	oik
仪	oik
伪	oiks
优	oiku
刽	oiln
领	oimbo
瓴	oimvn
今	oin
令	oini
邻	oinl
郐	oinl
贪	oino
念	oinp
含	oinr
衾	oinv
俯	oioi
俟	oiok
代	oip
偏	oisb
翎	oismm
储	oiva
什	oj
午	oj
值	ojbm
倥	ojcm
侏	ojd
伎	oje
仗	ojk
佬	ojkp
使	ojlk
伫	ojm
傧	ojoc
佗	ojp
侥	ojpu
估	ojr
做	ojrk
倌	ojrr
偾	ojto
缶	oju
矢	ok
攵	ok
侑	okb
僚	okcf
矮	okhdv
矫	okhkl
俺	oklu
佐	okm
倚	okmr
短	okmrt
侉	okms
仇	okn
矧	oknl
鳘	oknwm
雉	okog
矬	okoog
悠	okp
知	okr
佑	okr
仂	oks
伽	oksr
矩	okss
侠	okt
繁	okvif
个	ol
仲	ol
修	olhh
倏	olhk
介	oll
候	ollk
佛	olln
侯	olmk
佻	olmo
俳	olmy
攸	olok
们	ols
伸	olwl
俜	olws
丘	om
仝	om
佰	oma
儒	ombb
俪	ombb
俞	ombn
愈	ombp
兵	omc
余	omd
伍	omdm
佥	omfm
全	omg
倒	omgn
乒	omh
乓	omi
侄	omig
舍	omjr
便	omlk
剑	omln
仁	omm
佘	ommf
会	ommi
仨	ommm
佞	ommv
畲	ommw
气	omn
仃	omn
邱	omnl
例	omnn
歙	omno
何	omnr
俩	omob
敛	omok
钅	omp
合	omr
龠	omrb
命	omrl
翕	omrm
龛	omrp
拿	omrq
盒	omrt
卸	omsl
俨	omth
岳	omu
僭	omua
伢	omvh
佤	omvn
傈	omwd
僳	omwd
僵	omwm
乞	on
亿	on
氲	onabt
像	onao
觎	onbhu
儋	oncr
氛	oncsh
仔	ond
你	onf
氮	onff
氡	onhey
毹	onhqu
仍	onhs
俑	onib
侈	onin
氪	onjru
氨	onjv
健	onkq
氕	onl
氘	onll
氚	onlll
氟	onlln
氯	onlme
氩	onmtc
氖	onnhs
氢	onnom
氰	onqmb
氧	ontq
氙	onu
氤	onwk
氦	onyvo
从	oo
俎	oobm
坐	oog
僬	oogf
伶	ooii
仵	ooj
伤	ooks
价	ooll
丛	oom
侩	oomi
俭	oomm
偷	oomn
仡	oon
众	ooo
伦	oop
怂	oop
作	oos
耸	oosj
伧	oosu
侮	oowy
化	op
仑	op
货	opbo
贷	opbo
他	opd
牮	ophq
华	opj
偬	opkp
倾	opmo
伥	opo
仳	opp
偕	oppa
佝	opr
岱	opu
袋	opyhv
年	oq
傣	oqke
俦	oqki
俸	oqkq
倩	oqmb
债	oqmo
传	oqni
伟	oqs
傲	oqsk
智	ora
保	ord
侃	orhu
颌	ormb
颔	ormbo
俣	ormk
舒	ornin
鸽	orpym
侣	orr
假	orse
促	oryo
乍	os
偃	osav
榘	osd
仞	oshi
佴	osj
倨	osjr
伊	osk
伛	osk
侵	osme
伺	osmr
怎	osp
伲	osp
僻	osrj
仓	osu
倔	osuu
借	ota
供	otc
偌	otkr
舞	otniq
佯	otq
儆	otrk
仙	ou
缺	oudk
戗	oui
创	ouln
缸	oum
催	ouog
罐	outrg
罅	ouypd
似	ovio
佃	ow
倮	owd
俚	owg
偶	owlb
儇	owlv
偎	owmv
儡	owww
每	owyi
仆	oy
倬	oyaj
侦	oybo
傍	oybs
佼	oyck
僦	oyfu
住	oyg
伉	oyhn
仿	oyhs
依	oyhv
侪	oykl
企	oylm
信	oymr
佧	oymy
敏	oyok
停	oyrn
位	oyt
僮	oytg
倍	oytr
禽	oyub
毓	oyyiu
心	p
旨	pa
旬	pa
愠	pabt
惺	pahm
慨	paiu
怛	pam
悍	pamj
郇	panl
惕	paph
恨	pav
慢	pawe
憬	payf
惆	pbgr
恽	pbkq
惧	pbmc
恫	pbmr
恻	pbon
惘	pbtv
忪	pci
悌	pcnh
悦	pcru
憎	pcwa
惮	pcwj
也	pd
憷	pddo
忖	pdi
快	pdk
悚	pdl
懒	pdlo
颖	pdmbo
怪	peg
颍	pembo
怊	peq
悄	pfb
惝	pfbr
恍	pfmu
恃	pgdi
怯	pgi
悻	pgtj
必	ph
怕	pha
惶	phag
懊	phbk
恤	phbt
悸	phdd
愀	phdf
恪	pher
勿	phh
忏	phj
恬	phjr
刎	phln
忻	phml
忽	php
性	phqm
愧	phui
勾	pi
勺	pi
悛	pice
怵	pid
匍	pijb
惨	pikh
忧	piku
慵	pilb
慷	pile
匀	pim
怿	peq
怡	pir
憾	pirp
惦	piyr
慎	pjbc
悖	pjbd
忮	pje
惋	pjnu
鸨	pjpym
怙	pjr
愤	pjto
恢	pkf
匆	pkk
怖	pklb
肄	pklq
惰	pkmb
疑	pknio
惭	pkql
忡	pl
怏	plbk
忱	plbu
悭	pleg
怫	plln
愦	plmo
悱	plmy
悯	plsk
恒	pmam
懦	pmbb
顷	pmbo
怀	pmf
怦	pmfj
恹	pmik
恸	pmis
鸵	pmjp
怃	pmku
悟	pmmr
邬	pmnl
匐	pmrw
鹱	pmtoe
怔	pmym
忆	pn
懈	pnbq
忸	png
长	po
愎	poae
惟	pog
憔	pogf
怜	poii
忤	poj
愉	pomn
忾	pomn
恰	pomr
怍	pos
怆	posu
悔	powy
比	pp
恂	ppa
皆	ppha
惚	pphp
毕	ppj
毙	ppmnp
怅	ppo
毖	ppph
情	pqmb
愫	pqmf
句	pr
悒	prau
劬	prks
够	prnin
鸲	prpym
愕	prrs
包	pru
乜	ps
切	psh
忉	psh
慑	psje
怄	psk
惬	pskt
怩	psp
世	pt
惜	pta
贳	ptbo
懂	pthg
懵	ptwu
慊	ptxc
慌	ptyu
屯	pu
匈	puk
刨	puln
惴	pumb
顿	pumbo
恺	pusu
乌	pvsm
甸	pw
悃	pwd
悝	pwg
惯	pwjo
愣	pwls
悼	pyaj
訇	pymr
悴	pyoj
惊	pyrf
枭	pysd
鸟	pysm
凫	pysn
岛	pysu
袅	pysv
憧	pytg
恼	pyuk
忙	pyv
懔	pywf
忭	pyy
手	q
捏	qag
蠢	qalii
担	qam
捍	qamj
提	qamo
揭	qapv
撮	qase
把	qau
授	qbbe
靓	qbbhu
探	qbcd
捋	qbdi
靛	qbjmo
挥	qbkq
援	qbme
静	qbnsd
摇	qbou
撄	qbov
拥	qbq
攫	qbue
扒	qc
揿	qcno
扮	qcsh
掸	qcwj
耒	qd
揸	qdam
耙	qdau
耥	qdfbr
耧	qdfdv
耖	qdfh
披	qdhe
耗	qdhqu
耱	qdidr
抹	qdj
抉	qdk
耘	qdmmi
耨	qdmvi
耔	qdnd
耠	qdomr
耜	qdrlr
耢	qdtbs
耕	qdtt
耩	qdttb
耦	qdwlb
耪	qdybs
搡	qeed
掇	qeee
搔	qeii
摊	qeog
择	qeq
捎	qfb
撇	qfbk
撑	qfbq
搅	qfbu
搂	qfdv
抄	qfh
拌	qfq
挡	qfsm
擞	qfvk
攥	qgbf
持	qgdi
挂	qgg
拮	qgr
撷	qgro
拍	qha
揪	qhdf
播	qhdw
扳	qhe
扦	qhj
捶	qhjm
括	qhjr
插	qhjx
契	qhk
挢	qhkl
掀	qhlo
抓	qhlo
折	qhml
拆	qhmy
投	qhne
托	qhp
恝	qhp
挈	qhq
擤	qhul
攒	qhuo
撬	qhuu
抵	qhvi
抑	qhvl
捭	qhwj
搜	qhxe
搬	qhye
搋	qhyn
找	qi
扩	qi
搏	qibi
贽	qibo
热	qif
焘	qif
垫	qig
捕	qijb
拔	qike
掺	qikh
拢	qikp
势	qiks
扰	qiku
蛰	qilmi
搪	qilr
挨	qiok
拭	qipm
鸷	qipym
挚	qiq
抬	qir
撼	qirp
护	qis
掮	qisb
捩	qisk
拚	qit
摭	qitf
拨	qive
絷	qivif
掂	qiyr
丰	qj
擦	qjbf
攮	qjbv
撺	qjcl
控	qjcm
挖	qjcn
技	qje
擀	qjjj
拷	qjks
捷	qjlo
揎	qjmm
拧	qjmn
砉	qjmr
艳	qjnau
邦	qjnl
摈	qjoc
挠	qjpu
彗	qjsm
慧	qjsmp
按	qjv
春	qka
赘	qkbo
鏊	qkc
撩	qkcf
寿	qkdi
泰	qke
秦	qkhd
奏	qkhk
舂	qkhx
獒	qkik
螯	qklmi
掩	qklu
骜	qklvm
捺	qkmf
掎	qkmr
挎	qkms
执	qkni
鳌	qknwm
奉	qkq
聱	qksj
挟	qkt
抛	qkus
拣	qkvc
揽	qliu
帮	qllb
蜇	qllmi
拂	qlln
挑	qlmo
排	qlmy
哲	qlr
踅	qlryo
扪	qls
搁	qlsr
抽	qlw
抻	qlwl
拽	qlwp
誓	qlymr
扛	qm
青	qmb
攉	qmbg
责	qmbo
擂	qmbw
麦	qme
抨	qmfj
捱	qmgg
掭	qmkp
抚	qmku
捂	qmmr
振	qmmv
打	qmn
拓	qmr
扼	qmsu
撅	qmto
表	qmv
素	qmvif
纛	qmwyf
毒	qmwyi
挽	qnau
换	qnbk
拯	qnem
扭	qng
揉	qnhd
扔	qnhs
掐	qnhx
专	qni
捅	qnib
抒	qnin
撖	qnjk
挺	qnkg
搦	qnmm
揆	qnok
麸	qnqo
挣	qnsd
扬	qnsh
搀	qnuy
撸	qnwa
夫	qo
替	qoa
规	qobhu
拊	qodi
推	qog
携	qogs
拎	qoii
捻	qoip
辇	qokq
拴	qomg
捡	qomm
揄	qomn
拾	qomr
挫	qoog
抡	qop
拖	qopd
抢	qosu
擒	qoyb
指	qpa
掬	qpfd
掏	qpou
批	qpp
揩	qppa
拘	qpr
抱	qpru
揲	qptd
捣	qpyu
揍	qqkk
捧	qqkq
抟	qqni
扶	qqo
撵	qqoq
扣	qr
挹	qrau
捐	qrb
损	qrbo
拐	qrks
操	qrrd
揖	qrsj
捌	qrsn
撰	qruc
抿	qrvp
捉	qryo
韦	qs
韫	qsabt
揠	qsav
韬	qsbhx
招	qshr
摄	qsje
揶	qsjl
据	qsjr
抠	qsk
捃	qskr
报	qsle
扫	qsm
摺	qsma
握	qsmg
擢	qsmg
敖	qsok
挪	qsql
擗	qsrj
拒	qss
韧	qsshi
摒	qstt
搌	qstv
掘	qsuu
措	qta
摸	qtak
撒	qtbk
捞	qtbs
拱	qtc
撕	qtcl
掷	qtkl
拦	qtmm
搽	qtod
搭	qtor
搓	qtqm
拼	qtt
搠	qtub
描	qtw
撙	qtwi
搛	qtxc
击	qu
扎	qu
揣	qumb
摧	quog
拙	quu
拟	qvio
拗	qvis
掾	qvno
拶	qvvn
捆	qwd
撂	qwhr
掼	qwjo
摁	qwkp
押	qwl
摆	qwli
擐	qwlv
掴	qwmi
摞	qwvf
拇	qwyi
扑	qy
掉	qyaj
撤	qybk
摘	qycb
挝	qydi
拄	qyg
抗	qyhn
摔	qyij
抖	qyj
挞	qyk
挤	qykl
扯	qylm
掖	qyok
摅	qypp
掳	qyps
拈	qyr
搞	qyrb
掠	qyrf
攘	qyrv
拉	qyt
揞	qyta
撞	qytg
掊	qytr
接	qytv
搐	qyvw
擅	qywm
口	r
口	r
唱	raa
唧	rail
喝	rapv
嘬	rase
吧	rau
邑	rau
哏	rav
嗳	rbbe
啁	rbgr
剐	rbln
咀	rbm
员	rbo
呗	rbo
嘤	rbov
鹃	rbpym
嗣	rbsmr
嚼	rbwi
只	rc
叭	rc
嗡	rcim
嗲	rckn
吖	rcl
吩	rcsh
噌	rcwa
呆	rd
喳	rdam
啉	rdd
噤	rddf
喇	rdln
嗽	rdlo
叹	re
啵	rede
嗓	reed
啜	reee
嗨	reoy
哨	rfb
唢	rfbo
咪	rfd
喽	rfdv
啖	rff
吵	rfh
咣	rfmu
吐	rg
噎	rgbt
哇	rgg
嗑	rgit
哧	rglc
郢	rgnl
咭	rgr
嘻	rgrr
嘭	rgth
嗥	rhaj
唣	rhap
噢	rhbk
响	rhbr
咱	rhbu
哝	rhbv
啾	rhdf
咯	rher
咚	rhey
呼	rhfd
哌	rhhv
唾	rhjm
听	rhml
噬	rhmo
叽	rhn
哚	rhnd
吒	rhp
哦	rhqi
兄	rhu
嗅	rhuk
呱	rhvo
啤	rhwj
嗖	rhxe
唆	rice
嘛	ridd
嘁	rihf
哞	rihq
喊	rihr
吮	rihu
啷	riil
哺	rijb
吠	rik
咙	rikp
咏	rine
唉	riok
唳	risk
叶	rj
嘟	rjal
嗔	rjbc
嗦	rjbf
嚓	rjbf
喃	rjbj
嚏	rjbo
囔	rjbv
味	rjd
吱	rje
咤	rjhp
喀	rjhr
戢	rji
嘲	rjjb
哮	rjkd
喧	rjmm
咛	rjmn
啶	rjmo
嗜	rjpa
哓	rjpu
嘧	rjpu
咕	rjr
噻	rjtg
喷	rjto
嘹	rkcf
咴	rkf
喹	rkgg
呔	rki
唏	rkkb
咦	rkn
愍	rkp
啭	rkqi
另	rks
叻	rks
咖	rksr
吊	rlb
虽	rlmi
啡	rlmy
吗	rlvm
呻	rlwl
黾	rlwu
啸	rlx
踢	rmaph
蹋	rmasm
跟	rmav
嚅	rmbb
跚	rmbbm
踩	rmbd
嚯	rmbg
蹈	rmbhx
蹊	rmbvk
趴	rmc
哂	rmcw
蹭	rmcwa
吁	rmd
跛	rmdhe
踏	rmea
躞	rmffe
呸	rmfm
呈	rmg
跬	rmgg
蹯	rmhdw
路	rmher
跣	rmhgu
踵	rmhjg
踬	rmhjo
跃	rmhk
踽	rmhlb
跺	rmhnd
跌	rmhqo
躜	rmhuo
跞	rmhvd
踉	rmiav
践	rmij
跋	rmike
跆	rmir
蹁	rmisb
踱	rmite
躔	rmiwg
踮	rmiyr
蹿	rmjcl
踪	rmjmf
跎	rmjp
跷	rmjpu
吴	rmk
跨	rmkms
呖	rmks
跏	rmksr
呒	rmku
哽	rmlk
跳	rmlmo
蹰	rmmmi
唔	rmmr
跖	rmmr
趼	rmmt
蹶	rmmto
叮	rmn
蹂	rmnhd
趿	rmnhe
踊	rmnib
踺	rmnkq
跪	rmnmu
咧	rmnn
蹬	rmnot
呵	rmnr
跗	rmodi
踟	rmokr
跄	rmosu
趵	rmpi
跸	rmppj
跑	rmpru
蹀	rmptd
踌	rmqki
趺	rmqo
嗝	rmrb
躁	rmrrd
蹑	rmsje
踞	rmsjr
啄	rmso
距	rmss
呃	rmsu
跽	rmsup
哑	rmtc
蹼	rmtco
躇	rmtja
踯	rmtkl
躏	rmtlg
噘	rmto
蹒	rmtob
蹉	rmtqm
蹲	rmtwi
蹦	rmubb
嗄	rmue
嘎	rmui
踹	rmumb
呀	rmvh
号	rmvs
躐	rmvvv
踝	rmwd
嘌	rmwf
喱	rmwg
躅	rmwli
吓	rmy
踔	rmyaj
蹄	rmybb
跤	rmyck
蹴	rmyfu
跹	rmyhj
跻	rmykl
趾	rmylm
踣	rmytr
唤	rnbk
吼	rndu
吸	rnhe
哆	rnin
吲	rnl
啊	rnlr
吹	rno
饕	rnoiv
噔	rnot
噜	rnwa
呐	rob
呙	rob
咻	rod
咐	rodi
唯	rog
噍	rogf
呤	roii
吟	roin
勋	roks
喉	rolk
哙	romi
喻	romn
哈	romr
啥	romr
吃	ron
郧	ronl
唑	roog
哗	ropj
咋	ros
咿	rosk
呛	rosu
噙	royb
叱	rp
吣	rp
吻	rphh
唿	rphp
啕	rpou
吡	rpp
喈	rppa
哔	rppj
咆	rpru
喋	rptd
吨	rpu
呜	rpvm
鸣	rpym
啪	rqha
哳	rqhl
嗪	rqkd
唪	rqkq
唛	rqme
嗉	rqmf
啧	rqmo
呋	rqo
嗷	rqsk
啦	rqyt
吕	rr
咒	rrhn
哭	rrik
器	rrikr
骂	rrlvm
嚣	rrmor
鹭	rrpym
品	rrr
噪	rrrd
鼍	rrwmu
唰	rsbn
叨	rsh
嘱	rshb
嗫	rsje
呕	rsk
叩	rsl
咂	rslb
别	rsln
叼	rsm
颚	rsmbo
喔	rsmg
哐	rsmg
鄂	rsnl
呢	rsp
鹗	rspym
哪	rsql
噼	rsrj
噶	rtav
唠	rtbs
哄	rtc
嘶	rtcl
噗	rtco
嗌	rtct
嘞	rtjs
哎	rtk
喏	rtkr
呓	rtn
嗒	rtor
嗬	rtor
咩	rtq
嗟	rtqm
嗍	rtub
喵	rtw
嘈	rtwa
嚆	rtyb
巳	ru
嘣	rubb
导	rudi
喘	rumb
嗤	rumi
哕	runi
异	rut
巽	rutc
咄	ruu
呶	rve
吆	rvi
呦	rvis
叫	rvl
哟	rvmi
喙	rvno
民	rvp
咝	rvvm
喟	rwb
哩	rwg
嘿	rwgf
咽	rwk
嗯	rwkp
呷	rwl
喁	rwlb
喂	rwmv
鄙	rwnl
卟	ry
啼	rybb
嘀	rycb
咬	ryck
吭	ryhn
唷	ryib
哒	ryk
哜	rykl
啃	rymb
呲	rymp
唁	rymr
啮	rymu
咔	rymy
嗵	rynb
足	ryo
啐	ryoj
嘴	rypb
嘘	rypc
唬	rypn
噱	rypo
哼	ryrn
嚎	ryro
嚷	ryrv
嗾	rysk
喑	ryta
噫	rytp
唼	rytv
咳	ryvo
尸	s
刷	sbln
匹	sc
殿	schne
尿	se
臀	seb
犀	sehq
颞	sembo
聚	seooo
翳	sesmm
娶	sev
屑	sfb
屎	sfd
尉	sfdi
屡	sfdv
戳	sgi
刀	sh
鬈	shfqu
髯	shgb
髻	shgr
鬏	shhdf
髦	shhqu
刃	shi
戮	shi
鬃	shjmf
鬓	shjoc
属	shlb
匠	shml
髡	shmu
髹	shod
履	shoe
屐	shoe
屣	shoo
屦	shov
鹨	shpym
尾	shqu
召	shr
髫	shshr
鬣	shvvv
鬟	shwlv
髭	shymp
熨	sif
髟	sihhh
肆	silq
习	sim
忍	sip
慰	sip
匾	sisb
耳	sj
臂	sjb
鐾	sjc
聪	sjcrp
檗	sjd
取	sje
聂	sjee
耿	sjf
壁	sjg
聃	sjgb
聊	sjhhl
聒	sjhjr
聍	sjjmn
屠	sjka
耽	sjlbu
聩	sjlmo
聘	sjlws
璧	sjmgi
耵	sjmn
甓	sjmvn
耶	sjnl
聆	sjoii
擘	sjq
居	sjr
职	sjrc
劈	sjsh
联	sjtk
嬖	sjv
襞	sjyhv
耻	sjylm
譬	sjymr
区	sk
尹	sk
殴	skhne
瓯	skmvn
尻	skn
欧	skno
鸥	skpym
匦	skqn
君	skr
卩	sl
匝	slb
卫	slm
颐	slmbo
匮	slmo
匪	slmy
赜	slqmo
臣	slsl
届	slw
卧	sly
彐	sm
刁	sm
帚	smblb
寻	smdi
灵	smf
匡	smg
屋	smig
层	smmi
翟	smog
司	smr
羽	smsim
羿	smt
翼	smwtc
翠	smyoj
骧	smyrv
翌	smyt
孱	sndd
屙	snlr
尺	so
昼	soam
医	sok
鄹	sonl
咫	sorc
尽	soy
尼	sp
屁	spp
屉	spt
那	sqnl
叵	sr
劭	srks
剧	srln
邵	srnl
郡	srnl
慝	srp
群	srtq
辟	srytj
巨	ss
局	ssr
凹	ssu
兕	ssuu
匿	stkr
羼	stqq
屏	stt
展	stv
己	su
已	su
熙	suf
改	suok
忌	sup
屈	suu
郾	svnl
匣	swl
廿	t
昔	ta
菖	taa
萌	tab
莳	tadi
草	taj
莫	tak
暮	taka
幕	takb
墓	takg
蓦	takm
慕	takp
摹	takq
募	taks
葛	tapv
鹊	tapym
蕞	tase
芭	tau
茛	tav
蔓	tawe
觏	tbbhu
典	tbc
蓥	tbc
荣	tbd
菜	tbd
槊	tbd
荥	tbe
荧	tbf
藤	tbfe
塑	tbg
茔	tbg
荦	tbhq
苋	tbhu
藐	tbhu
黼	tbijb
黻	tbike
荤	tbkq
劳	tbks
萤	tbli
前	tbln
蒯	tbln
苴	tbm
颟	tbmbo
莹	tbmi
蒙	tbmo
茼	tbmr
莩	tbnd
煎	tbnf
剪	tbnh
茕	tbnj
翦	tbnm
蔡	tbof
散	tbok
莺	tbpm
苘	tbr
营	tbrr
菔	tbse
苜	tbu
荽	tbv
萦	tbvf
共	tc
业	tc
普	tca
期	tcb
益	tcbt
黹	tcfb
基	tcg
夔	tche
斯	tchml
蓊	tcim
蕲	tcjl
邺	tcnl
欺	tcno
歉	tcno
恭	tcp
鹣	tcpym
巷	tcru
芬	tcsh
凿	tctu
綦	tcvif
酋	tcwm
葙	tdbu
菘	tdci
菥	tdhl
茉	tdj
蔌	tdlo
苯	tdm
莱	tdt
菹	tebm
菠	tede
莎	tefh
落	tehr
蒎	tehv
藩	tehw
蒲	teib
薄	teii
蒗	teiv
劐	teln
茳	tem
萍	temj
菏	temr
荡	tenh
藻	terd
蕖	tesd
范	tesu
茫	teyv
蔽	tfbk
蒌	tfdv
薮	tfvk
芏	tg
苒	tgb
盖	tgbt
菱	tgce
蔷	tgcw
羔	tgf
羹	tgftk
葑	tggi
羲	tghds
羌	tghu
羡	tgimo
美	tgk
颧	tgmbo
莰	tgno
恙	tgp
鹳	tgpym
薹	tgrg
姜	tgv
葩	thau
首	thbu
莉	thdn
莠	thds
萎	thdv
蕃	thdw
薰	thgf
藜	thhe
茆	thhl
芊	thj
蘖	thj
孽	thjd
茱	thjd
董	thjg
荞	thkl
芹	thml
芟	thne
薇	thok
荇	thon
蘅	thon
蓰	thoo
茚	thpl
莪	thqi
薛	thrj
芪	thvp
蔸	thvu
萆	thwj
蓖	thwp
萸	thxo
莨	tiav
蘑	tidr
蘼	tidy
茂	tih
蒇	tiho
葳	tihv
莆	tijb
茇	tike
茏	tikp
莽	tikt
茨	timo
藏	tims
芝	tino
鹚	tipym
苔	tir
芦	tis
蔗	titf
蔼	tivv
卅	tj
靼	tjam
靶	tjau
荸	tjbd
带	tjblb
蓉	tjcr
芰	tje
鞘	tjfb
鞋	tjgg
鞒	tjhkl
靳	tjhml
蕙	tjip
鞍	tjjv
著	tjka
勒	tjks
鞅	tjlbk
萋	tjlv
苎	tjm
蔻	tjme
萱	tjmm
菪	tjmr
莞	tjmu
鞔	tjnau
鞣	tjnhd
鄣	tjnl
菀	tjnu
蓿	tjoa
鞭	tjomk
靴	tjop
蓍	tjpa
鞠	tjpfd
荛	tjpu
鞫	tjpyr
苦	tjr
葫	tjrb
菅	tjrr
鞴	tjthb
鞯	tjtkd
鞲	tjttb
鞑	tjyk
关	tk
艾	tk
檠	tkd
荻	tkhf
获	tkhk
莸	tkhu
荐	tkld
茬	tklg
萘	tkmf
荑	tkn
艽	tkn
芄	tkni
郑	tknl
蒺	tkok
擎	tkq
若	tkr
惹	tkrp
苏	tksc
茄	tksr
荔	tkss
荚	tkt
警	tkymr
英	tlbk
萜	tlbr
蓝	tlit
革	tlj
蒋	tlmi
茧	tlmi
蒉	tlmo
菲	tlmy
燕	tlpf
堇	tlqm
蔺	tlsg
黄	tlwc
萧	tlx
甘	tm
薷	tmbb
藿	tmbg
觐	tmbhu
蕾	tmbw
茜	tmcw
某	tmd
芋	tmd
蒜	tmff
苹	tmfj
苤	tmfm
勤	tmks
苈	tmks
芜	tmku
兰	tmm
其	tmmc
芸	tmmi
芫	tmmu
甚	tmmv
鄞	tmnl
邯	tmnl
薤	tmnm
苛	tmnr
蕤	tmom
葬	tmpt
苊	tmsu
蕨	tmto
芽	tmvh
蓐	tmvi
蘸	tmwf
蕈	tmwj
苄	tmy
蔫	tmyf
艺	tn
芎	tn
菟	tnai
荪	tndf
菰	tndo
芤	tndu
蒸	tnef
芨	tnhe
艿	tnhs
萏	tnhx
茅	tnih
茗	tnir
苑	tniu
莛	tnkg
荫	tnlb
萨	tnlh
蓟	tnmn
藓	tnmq
蔬	tnmu
蓣	tnno
芡	tno
葵	tnok
茎	tnom
荬	tnyk
芮	tob
茶	tod
苻	todi
萑	tog
茌	tog
蕉	togf
荏	tohg
苓	toii
茯	toik
芩	toin
蘩	tokf
莜	tolk
养	toll
芥	toll
荼	tomd
荃	tomg
荟	tomi
蔹	tomk
莶	tomm
荷	tomr
苁	too
花	top
葆	tord
苍	tosu
莓	towy
蓓	toyr
莅	toyt
芯	tp
荀	tpa
菊	tpfd
芴	tphh
芍	tpi
葡	tpib
葱	tpkp
苌	tpo
萄	tpou
芘	tpp
蒈	tppa
荜	tppj
蕊	tppp
苟	tpr
苞	tpru
茑	tpvm
羊	tq
芈	tq
羯	tqapv
着	tqbu
藉	tqda
藕	tqdb
葜	tqhk
羝	tqhvi
羧	tqice
菝	tqie
蓁	tqkd
差	tqm
菁	tqmb
羞	tqng
羟	tqnom
芙	tqo
羚	tqoii
苇	tqs
翔	tqsmm
羰	tqukf
蕺	trji
鄯	trnl
莴	trob
敬	trok
莒	trr
萼	trrs
葭	trse
葺	trsj
苠	trvp
蔚	tsfi
苕	tshr
蕻	tsic
茸	tsj
节	tsl
蓼	tsmh
荨	tsmi
荩	tsoy
薜	tsrj
苣	tss
芑	tsu
并	tt
井	tt
荆	ttln
苷	ttm
萁	ttmc
葚	ttmv
瓶	ttmvn
善	ttr
蒴	ttub
蠲	ttwli
蒹	ttxc
朔	tub
馘	tuirm
菡	tune
茁	tuu
戡	tvi
孳	tvid
兹	tvii
苡	tvio
慈	tvip
菇	tvjr
勘	tvks
荮	tvm
药	tvmi
薅	tvmi
荭	tvmm
蕴	tvmt
莼	tvmu
茹	tvr
芗	tvvh
斟	tvyj
苗	tw
曲	tw
曹	twa
尊	twdi
菌	twhd
猷	twik
奠	twk
茵	twk
蒽	twkp
薯	twla
蔑	twli
萝	twln
甍	twln
薨	twlp
瞢	twlu
葸	twp
鹋	twpym
茴	twr
兼	txc
蒂	tybb
蒡	tybs
茭	tyck
薪	tydl
菽	tyfe
蓬	tyhj
芳	tyhs
茺	tyiu
荠	tykl
莲	tykq
芾	tylb
芷	tylm
茈	tymp
萃	tyoj
苫	tyr
蒿	tyrb
藁	tyrd
葶	tyrn
蔟	tysk
菸	tysy
莘	tytj
薏	tytp
菩	tytr
蓠	tyub
芒	tyv
蕹	tyvg
荒	tyvu
蓄	tyvw
蓑	tywv
蘧	tyyo
山	u
嵋	uahu
岜	uau
崩	ubb
岘	ubhu
岗	ubk
颛	ubmbo
峒	ubmr
峪	ucor
崧	udci
崃	udt
凼	ue
峄	ueq
峭	ufb
嵴	ufcb
嶙	ufdq
嵝	ufdv
峙	ugdi
匕	uh
嵊	uhdp
峰	uhej
峁	uhhl
峤	uhkl
岚	uhnk
峨	uhqi
嵬	uhui
巍	uhvi
峻	uice
崴	uihv
鬯	uip
崆	ujcm
巅	ujco
岐	uje
崇	ujmf
岵	ujr
凶	uk
岽	ukd
炭	ukf
崤	ukkb
崦	uklu
崎	ukmr
崭	ukql
峡	ukt
屮	ul
岿	ulls
岫	ulw
崖	umgg
蚩	umli
岸	ummj
岢	umnr
豳	umoo
岩	umr
岍	umt
岈	umvh
崾	umwv
函	une
岌	unhe
岁	uni
刿	unln
嶝	unot
峥	unsd
崔	uog
岭	uoii
岑	uoin
嵛	uomn
屹	uon
峋	upa
嶷	upko
岣	upr
岷	urvp
岖	usk
岂	usu
屺	usu
崛	usuu
嵘	utbd
崂	utbs
嵌	utmo
酆	utnl
嵯	utqm
嵫	utvi
出	uu
觊	uubhu
粜	uufd
凯	uuhn
剀	uuln
祟	uummf
幽	uvii
崮	uwjr
岬	uwl
崽	uwp
嵩	uyrb
崞	uyrd
屿	uysm
嶂	uytj
女	v
娼	vaa
媪	vabt
媚	vahu
妲	vam
嫒	vbbe
姗	vbbm
姐	vbm
媛	vbme
娣	vcnh
婵	vcwj
断	vdhml
嫩	vdlk
剿	vdln
奴	ve
努	veks
帑	velb
驽	velvm
弩	ven
孥	vend
胬	veobo
怒	vep
嫦	vfbb
妙	vfh
嫱	vgcw
娃	vgg
奘	vgk
嬉	vgrr
妊	vhg
姝	vhjd
妖	vhk
娇	vhkl
飨	vhoiv
婚	vhpa
娥	vhqi
姓	vhqm
媳	vhup
婢	vhwj
媲	vhwp
嫂	vhxe
幺	vi
厶	vi
娘	viav
嬷	vidi
糸	vif
幼	viks
妫	viks
以	vio
始	vir
妒	vis
幻	vis
畿	viw
妹	vjd
妓	vje
姹	vjhp
姥	vjkp
婶	vjll
婕	vjlo
嫁	vjmo
婉	vjnu
嫔	vjoc
娆	vjpu
姑	vjr
姨	vkn
嫉	vkok
凵	vl
爿	vlm
姚	vlmo
收	vlok
娴	vlsd
妈	vlvm
妯	vlw
娉	vlws
姊	vlxh
缇	vmamo
绲	vmapp
缦	vmawe
绷	vmbb
绶	vmbbe
绸	vmbgr
纲	vmbk
组	vmbm
缓	vmbme
缨	vmbov
孀	vmbu
缈	vmbuh
绥	vmbv
绨	vmcnh
纷	vmcsh
缯	vmcwa
缃	vmdbu
纣	vmdi
缀	vmeee
绎	vmeq
绡	vmfb
绱	vmfbr
缕	vmfdv
彝	vmfft
纱	vmfh
绊	vmfq
绻	vmfqu
绫	vmgce
结	vmgr
缬	vmgro
绵	vmhab
绣	vmhds
绦	vmhed
绛	vmheq
络	vmher
终	vmhey
纤	vmhj
缎	vmhje
缍	vmhjm
绗	vmhon
缴	vmhsk
缵	vmhuo
纸	vmhvp
绺	vmhyr
纩	vmi
戕	vmi
缚	vmibi
缄	vmihr
线	vmij
绒	vmij
绂	vmike
绐	vmir
编	vmisb
缠	vmiwg
奸	vmj
缜	vmjbc
绪	vmjka
综	vmjmf
绽	vmjmo
续	vmjnk
缩	vmjoa
缤	vmjoc
绕	vmjpu
绾	vmjrr
缭	vmkcf
绮	vmkmr
绔	vmkms
纨	vmkni
妩	vmku
练	vmkvc
缆	vmliu
绋	vmlln
绿	vmlme
缋	vmlmo
绯	vmlmy
绅	vmlwl
红	vmm
缙	vmmca
纡	vmmd
绠	vmmlk
纭	vmmmi
娠	vmmv
缛	vmmvi
缥	vmmwf
缅	vmmwl
缰	vmmwm
绝	vmnau
纽	vmng
级	vmnhe
纾	vmnin
经	vmnom
绉	vmnsm
纳	vmob
维	vmog
缑	vmolk
绘	vmomi
缏	vmomk
给	vmomr
纥	vmon
纵	vmoo
纶	vmop
绚	vmpa
约	vmpi
彘	vmpop
纰	vmpp
绁	vmpt
纯	vmpu
绑	vmqjl
绩	vmqmo
纬	vmqs
辔	vmr
绢	vmrb
织	vmrc
绳	vmrlu
缗	vmrpa
缲	vmrrd
缉	vmrsj
纫	vmshi
绍	vmshr
缪	vmsmh
纪	vmsu
妍	vmt
娅	vmtc
缢	vmtct
缂	vmtlj
绀	vmtm
缮	vmttr
缣	vmtxc
绌	vmuu
继	vmvfd
纠	vmvl
缘	vmvno
缫	vmvvd
缁	vmvvw
细	vmw
嫖	vmwf
缳	vmwlv
缌	vmwp
缧	vmwvf
绰	vmyaj
缔	vmybb
绞	vmyck
嫣	vmyf
缝	vmyhj
缒	vmyhr
纺	vmyhs
统	vmyiu
纹	vmyk
缱	vmylr
缟	vmyrb
缡	vmyub
娩	vnau
好	vnd
妞	vng
奶	vnhs
妤	vnin
婀	vnlr
彖	vnmo
婿	vnob
妗	voin
蠡	volii
她	vpd
妁	vpi
妣	vpp
婧	vqmb
婊	vqmv
如	vr
娟	vrb
娱	vrmk
娲	vrob
恕	vrp
絮	vrvif
娓	vshu
妪	vsk
姬	vsll
妇	vsm
妮	vsp
娜	vsql
妃	vsu
嫫	vtak
媒	vtmd
姘	vtt
媾	vttb
嫌	vtxc
媸	vumi
乡	vvh
姒	vvio
丝	vvm
纟	vvm
鸶	vvmpm
邕	vvrau
巛	vvv
甾	vvw
巢	vvwd
娌	vwg
姻	vwk
嫘	vwvf
姆	vwyi
嫡	vycb
姣	vyck
妨	vyhs
婷	vyrn
嫜	vytj
嬗	vywm
田	w
胃	wb
愚	wbp
四	wc
果	wd
困	wd
团	wdh
颗	wdmbo
夥	wdnin
黠	wfgr
黢	wfice
默	wfik
黪	wfikh
黩	wfjnk
黟	wfnin
黔	wfoin
畔	wfq
圈	wfqu
黜	wfuu
黝	wfvis
黥	wfyrf
黯	wfyta
里	wg
黑	wgf
墨	wgfg
畦	wgg
野	wgnin
圉	wgtj
畈	whe
略	wher
图	whey
圃	wijb
畎	wik
毋	wj
贯	wjbo
畹	wjnu
固	wjr
因	wk
囿	wkb
畸	wkmr
恩	wkp
男	wks
甲	wl
禺	wlbi
罾	wlcwa
罢	wlgi
罴	wlgif
睾	wlgtj
罚	wlivn
罱	wljbj
置	wljbm
署	wljka
罟	wljr
罨	wlklu
罪	wllmy
罘	wlmf
罡	wlmym
罗	wlni
蜀	wlpli
罹	wlpog
鸭	wlpym
羁	wltjm
罩	wlyaj
詈	wlymr
国	wmgi
畀	wml
圄	wmmr
园	wmmu
町	wmn
畏	wmv
囝	wnd
墅	wng
囚	wo
畛	wohh
囹	woii
畋	wok
界	woll
囵	wop
思	wp
囫	wphh
毗	wpp
囤	wpu
畴	wqki
圊	wqmb
围	wqs
回	wr
圆	wrbo
嬲	wsvws
囡	wv
累	wvif
圜	wwlv
母	wyi
疃	wytg
曰	xa
晖	xabkq
旰	xamj
冕	xanau
煦	xarf
晾	xayrf
冗	xbhn
脎	xbkd
肽	xbki
肛	xbm
冢	xbmso
贱	xboij
肼	xbtt
睢	xbuog
镓	xcjmo
丫	xcl
钩	xcpi
铳	xcyiu
锿	xcyrv
板	xdhe
杠	xdm
柰	xdmmf
杓	xdpi
赉	xdtbo
梓	xdytj
沓	xea
漱	xedlo
双	xee
叉	xei
浠	xekkb
溃	xelmo
灞	xembb
洒	xemcw
泓	xeni
淮	xeog
渝	xeomn
柒	xepd
敞	xfbok
炯	xfbr
炔	xfdk
尘	xfg
圹	xgi
嘉	xgrtr
丿	xh
秉	xhdl
剁	xhdln
簌	xhdlo
夂	xhe
冬	xhey
鸱	xhipy
梨	xhnd
凤	xhne
彳	xho
筱	xholk
鸹	xhrpy
憩	xhup
丶	xi
床	xid
魔	xiddi
氵	xiim
戋	xij
庋	xije
庆	xik
亠	xim
庀	xip
忒	xipp
怠	xirp
扁	xisbt
弁	xit
讹	xivop
诣	xivpa
宋	xjd
廾	xjj
蹇	xjtco
杀	xkd
瘌	xkdln
堑	xklg
疴	xkmnr
夷	xkn
旮	xkna
尢	xku
丨	xl
蚬	xlibh
蛊	xlibt
冖	xln
冂	xls
闼	xlsyk
裢	xlykq
郦	xmbnl
贡	xmbo
鸸	xmbpy
灭	xmf
玉	xmgi
郅	xmgnl
玫	xmgok
历	xmks
亍	xmmn
亏	xmmvs
恐	xmnp
酃	xmrnl
歌	xmrno
劢	xmsks
顽	xmumb
丞	xnem
弘	xni
巯	xnmyi
久	xno
汆	xoe
氽	xxoe
隹	xog
佶	xogr
仪	xoik
郐	xoinl
午	xoj
攵	xok
佑	xokr
仲	xol
仝	xom
俪	xombb
仃	xomn
僳	xomwd
亿	xon
怂	xoop
仑	xop
贷	xopbo
颌	xormb
伛	xosk
伲	xosp
旬	xpa
勺	xpi
忾	xpomn
忉	xpsh
抓	xqhlo
恝	xqhp
扩	xqi
焘	xqif
擢	xqsmg
扎	xqu
邑	xrau
呗	xrbo
叭	xrc
嚓	xrjbf
嘧	xrjpu
叻	xrks
跖	xrmmr
呙	xrob
啥	xromr
吣	xrp
哐	xrsmg
嗬	xrtor
戮	xshi
屐	xshoe
慰	xsip
鐾	xsjc
尹	xsk
刁	xsm
郡	xsrnl
已	xsu
蓥	xtbc
菜	xtbd
茔	xtbg
藐	xtbhu
蒯	xtbln
业	xtc
歉	xtcno
茱	xthjd
蘅	xthon
莞	xtjmu
艾	xtk
艽	xtkn
茧	xtlmi
芋	xtmd
苈	xtmks
邯	xtmnl
芎	xtn
茌	xtog
芥	xtoll
芈	xtq
井	xtt
孳	xtvid
薅	xtvmi
曲	xtw
茵	xtwk
甍	xtwln
屺	xusu
厶	xvi
妫	xviks
幻	xvis
戕	xvmi
绒	xvmij
纟	xvvm
困	xwd
囗	xxbm
扌	xxdm
汩	xxea
渥	xxesm
犬	xxik
阝	xxnl
飞	xxno
槊	xxtbd
蘖	xxthj
荮	xxtvm
达	xxyk
迥	xybr
奕	xyck
颜	xyhmb
头	xyk
憝	xykp
遗	xylmo
忐	xymp
亭	xyrbn
点	xyrf
迸	xytt
膂	xyvb
邋	xyvvv
卜	y
桌	yad
卓	yaj
歆	yano
暹	yaog
韵	yapim
遏	yapv
韶	yashr
遢	yasm
退	yav
邈	ybhu
帝	yblb
睿	ybmcu
望	ybmg
贞	ybo
遥	ybou
啻	ybr
迥	ybr
敲	ybye
旁	ybyhs
六	yc
觑	ycbhu
商	ycbr
銮	ycc
栾	ycd
变	yce
兖	ycihu
衮	ycihv
交	yck
奕	yck
蛮	yclmi
弯	ycn
孪	ycnd
递	ycnh
脔	ycobo
恋	ycp
鸾	ycpym
挛	ycq
弈	yct
峦	ycu
娈	ycv
新	ydhml
过	ydi
孰	ydkni
速	ydl
郭	ydnl
敦	ydok
鹑	ydpym
攴	ye
督	yebu
粲	yefd
壑	yeg
餐	yeoiv
逍	yfb
迷	yfd
遴	yfdq
叔	yfe
就	yfiku
主	yg
逵	ygcg
广	yh
迫	yha
遑	yhag
透	yhds
逶	yhdv
返	yhe
逢	yhej
逄	yheq
造	yhgr
选	yhgu
彦	yhhhh
遛	yhhw
迁	yhj
适	yhjr
遁	yhju
颜	yhmb
频	yhmbo
近	yhml
逅	yhmr
亢	yhn
迭	yhqo
追	yhrr
方	yhs
邀	yhsk
衣	yhv
迎	yhvl
裒	yhxv
育	yib
逡	yice
述	yid
熟	yif
塾	yig
充	yihu
逋	yijb
逑	yije
率	yioj
迨	yir
遍	yisb
弃	yit
遮	yitf
斗	yj
邃	yjco
辣	yjdl
赣	yjheo
彰	yjhhh
瓣	yjhoj
辨	yjilj
辩	yjivj
逭	yjrr
辫	yjvmj
文	yk
达	yk
头	yk
逖	ykhf
逛	ykhg
齐	ykll
齑	yklll
刘	ykln
斓	yklsw
斋	ykmbl
斌	ykmpm
郊	yknl
效	ykok
憝	ykp
连	ykq
吝	ykr
边	yks
迦	yksr
紊	ykvif
市	ylb
逮	yle
衷	ylhv
剂	ylln
止	ylm
逯	ylme
步	ylmh
逃	ylmo
遗	ylmo
遣	ylmr
亦	ylnc
迪	ylw
上	ym
肯	ymb
逦	ymbb
迂	ymd
还	ymf
歧	ymje
颤	ymmbo
运	ymmi
言	ymmr
远	ymmu
欤	ymno
此	ymp
忐	ymp
雌	ympog
逗	ymrt
逼	ymrw
迈	yms
逐	ymso
齿	ymuo
迓	ymvh
卡	ymy
逸	ynai
赢	ynbo
邂	ynbq
逊	yndf
迩	ynf
彪	ynhhh
袤	ynhv
通	ynib
迅	ynj
蠃	ynlmi
颃	ynmbo
辽	ynn
迳	ynom
羸	yntq
嬴	ynv
褒	yodv
毅	yohne
颦	yohwj
迕	yoj
劾	yoks
刻	yoln
颏	yombo
途	yomd
逾	yomn
迄	yon
夜	yonk
卒	yooj
戆	yop
迤	yopd
迮	yos
虍	yp
赀	ypbo
柴	ypd
虎	yphn
虏	ypks
些	ypmm
砦	ypmr
觜	ypnbq
虑	ypp
虞	yprmk
虐	ypsm
虚	yptc
紫	ypvif
虔	ypyk
訾	ypymr
逝	yqhl
亵	yqiv
违	yqs
遨	yqsk
占	yr
膏	yrbb
觇	yrbhu
亮	yrbn
亭	yrbn
豪	yrbo
亳	yrbp
高	yrbr
毫	yrbu
京	yrf
点	yrf
哀	yrhv
战	yri
剖	yrln
逞	yrmg
瓿	yrmvn
享	yrnd
烹	yrnf
部	yrnl
亨	yrnn
襄	yrrv
遐	yrse
乩	yru
卢	ys
迢	yshr
与	ysm
颅	ysmbo
邡	ysnl
迟	yso
旃	ysoby
旌	ysohm
旄	ysohu
旅	ysohv
旆	ysojb
放	ysok
旖	ysokr
旋	ysono
族	ysook
施	ysopd
旎	ysosp
旗	ysotc
於	ysoy
旒	ysoyu
鸬	yspym
避	ysrj
立	yt
音	yta
竟	ytahu
章	ytaj
意	ytap
竭	ytapv
遒	ytcw
亲	ytd
竦	ytdl
产	yth
飒	ythnk
道	ythu
竣	ytice
辛	ytj
送	ytk
遂	ytpo
靖	ytqmb
竞	ytrhu
翊	ytsmm
进	ytt
迸	ytt
遘	yttb
逆	ytu
端	ytumb
妾	ytv
遭	ytwa
童	ytwg
遵	ytwi
站	ytyr
龈	yuav
龃	yubm
龋	yuhlb
离	yukb
遄	yumb
龉	yummr
龄	yuoii
龀	yup
龅	yupru
鹫	yupym
龊	yuryo
龆	yushr
龌	yusmg
龇	yuymp
亡	yv
肓	yvb
膂	yvb
裔	yvbcr
盲	yvbu
壅	yvgg
饔	yvgv
雍	yvhg
亥	yvho
瓤	yvhvo
玄	yvi
畜	yviw
邙	yvnl
忘	yvp
氓	yvrvp
妄	yvv
巡	yvvv
邋	yvvv
亩	yw
裹	ywdv
卤	ywk
遇	ywlb
逻	ywln
衰	ywmv
禀	ywrf
卣	yws
鹾	ywtqm
卞	yy
这	yyk
迹	yylc
遽	yypo
‘	za
’	za
“	za
”	za
〔	za
〕	za
〈	za
〉	za
《	za
》	za
…	za
‘	za
’	za
“	za
”	za
〔	za
〕	za
〈	za
〉	za
《	za
》	za
「	za
」	za
『	za
』	za
〖	za
〗	za
【	za
】	za
№	za
☆	za
★	za
○	za
●	za
◎	za
◇	za
◆	za
□	za
■	za
△	za
▲	za
※	za
→	za
←	za
↑	za
↓	za
〓	za
ⅰ	zb
ⅱ	zb
ⅲ	zb
ⅳ	zb
ⅴ	zb
ⅵ	zb
ⅶ	zb
ⅷ	zb
ⅸ	zb
ⅹ	zb
⒈	zba
⒉	zba
⒊	zba
⒋	zba
⒌	zba
⒍	zba
⒎	zba
⒏	zba
⒐	zba
⒑	zba
⒒	zba
⒓	zba
⒔	zba
⒕	zba
⒖	zba
⒗	zba
⒘	zba
⒙	zba
⒚	zba
⒛	zba
⑴	zbb
⑵	zbb
⑶	zbb
⑷	zbb
⑸	zbb
⑹	zbb
⑺	zbb
⑻	zbb
⑼	zbb
⑽	zbb
⑾	zbb
⑿	zbb
⒀	zbb
⒁	zbb
⒂	zbb
⒃	zbb
⒄	zbb
⒅	zbb
⒆	zbb
⒇	zbb
①	zbc
②	zbc
③	zbc
④	zbc
⑤	zbc
⑥	zbc
⑦	zbc
⑧	zbc
⑨	zbc
⑩	zbc
㈠	zbd
㈡	zbd
㈢	zbd
㈣	zbd
㈤	zbd
㈥	zbd
㈦	zbd
㈧	zbd
㈨	zbd
㈩	zbd
Ⅰ	zbe
Ⅱ	zbe
Ⅲ	zbe
Ⅳ	zbe
Ⅴ	zbe
Ⅵ	zbe
Ⅶ	zbe
Ⅷ	zbe
Ⅸ	zbe
Ⅹ	zbe
Ⅺ	zbe
Ⅻ	zbe
ぁ	zc
あ	zc
ぃ	zc
い	zc
ぅ	zc
う	zc
ぇ	zc
え	zc
ぉ	zc
お	zc
か	zc
が	zc
き	zc
ぎ	zc
く	zc
ぐ	zc
け	zc
げ	zc
こ	zc
ご	zc
さ	zc
ざ	zc
し	zc
じ	zc
す	zc
ず	zc
せ	zc
ぜ	zc
そ	zc
ぞ	zc
た	zc
だ	zc
ち	zc
ぢ	zc
っ	zc
つ	zc
づ	zc
て	zc
で	zc
と	zc
ど	zc
な	zc
に	zc
ぬ	zc
ね	zc
の	zc
は	zc
ば	zc
ぱ	zc
ひ	zc
び	zc
ぴ	zc
ふ	zc
ぶ	zc
ぷ	zc
へ	zc
べ	zc
ぺ	zc
ほ	zc
ぼ	zc
ぽ	zc
ま	zc
み	zc
む	zc
め	zc
も	zc
ゃ	zc
や	zc
ゅ	zc
ゆ	zc
ょ	zc
よ	zc
ら	zc
り	zc
る	zc
れ	zc
ろ	zc
ゎ	zc
わ	zc
ゐ	zc
ゑ	zc
を	zc
ん	zc
ァ	zd
ア	zd
ィ	zd
イ	zd
ゥ	zd
ウ	zd
ェ	zd
エ	zd
ォ	zd
オ	zd
カ	zd
ガ	zd
キ	zd
ギ	zd
ク	zd
グ	zd
ケ	zd
ゲ	zd
コ	zd
ゴ	zd
サ	zd
ザ	zd
シ	zd
ジ	zd
ス	zd
ズ	zd
セ	zd
ゼ	zd
ソ	zd
ゾ	zd
タ	zd
ダ	zd
チ	zd
ヂ	zd
ッ	zd
ツ	zd
ヅ	zd
テ	zd
デ	zd
ト	zd
ド	zd
ナ	zd
ニ	zd
ヌ	zd
ネ	zd
ノ	zd
ハ	zd
バ	zd
パ	zd
ヒ	zd
ビ	zd
ピ	zd
フ	zd
ブ	zd
プ	zd
ヘ	zd
ベ	zd
ペ	zd
ホ	zd
ボ	zd
ポ	zd
マ	zd
ミ	zd
ム	zd
メ	zd
モ	zd
ャ	zd
ヤ	zd
ュ	zd
ユ	zd
ョ	zd
ヨ	zd
ラ	zd
リ	zd
ル	zd
レ	zd
ロ	zd
ヮ	zd
ワ	zd
ヰ	zd
ヱ	zd
ヲ	zd
ン	zd
ヴ	zd
ヵ	zd
ヶ	zd
Α	zf
Β	zf
Γ	zf
Δ	zf
Ε	zf
Ζ	zf
Η	zf
Θ	zf
Ι	zf
Κ	zf
Λ	zf
Μ	zf
Ν	zf
Ξ	zf
Ο	zf
Π	zf
Ρ	zf
Σ	zf
Τ	zf
Υ	zf
Φ	zf
Χ	zf
Ψ	zf
Ω	zf
α	zf
β	zf
γ	zf
δ	zf
ε	zf
ζ	zf
η	zf
θ	zf
ι	zf
κ	zf
λ	zf
μ	zf
ν	zf
ξ	zf
ο	zf
π	zf
ρ	zf
σ	zf
τ	zf
υ	zf
φ	zf
χ	zf
ψ	zf
ω	zf
︵	zf
︶	zf
︹	zf
︺	zf
︿	zf
﹀	zf
︽	zf
︾	zf
﹁	zf
﹂	zf
﹃	zf
﹄	zf
︻	zf
︼	zf
︷	zf
︸	zf
︱	zf
	zf
︳	zf
︴	zf
А	zg
Б	zg
В	zg
Г	zg
Д	zg
Е	zg
Ё	zg
Ж	zg
З	zg
И	zg
Й	zg
К	zg
Л	zg
М	zg
Н	zg
О	zg
П	zg
Р	zg
С	zg
Т	zg
У	zg
Ф	zg
Х	zg
Ц	zg
Ч	zg
Ш	zg
Щ	zg
Ъ	zg
Ы	zg
Ь	zg
Э	zg
Ю	zg
Я	zg
а	zg
б	zg
в	zg
г	zg
д	zg
е	zg
ё	zg
ж	zg
з	zg
и	zg
й	zg
к	zg
л	zg
м	zg
н	zg
о	zg
п	zg
р	zg
с	zg
т	zg
у	zg
ф	zg
х	zg
ц	zg
ч	zg
ш	zg
щ	zg
ъ	zg
ы	zg
ь	zg
э	zg
ю	zg
я	zg
